Unit level ,Unit name ,Length Of Stay,Eligible ,Outcome,Parent present ,Parent not present,Proportion,Missing
1,Pilgrim General Hospital,A_7days,173,169,78,91,78 (46.2%),4 (2.3%)
1,Pilgrim General Hospital,B_8_14days,229,216,105,111,105 (48.6%),13 (5.7%)
1,Pilgrim General Hospital,C_15_21days,123,119,60,59,60 (50.4%),4 (3.3%)
1,Pilgrim General Hospital,D_22_28days,135,129,53,76,53 (41.1%),6 (4.4%)
1,Pilgrim General Hospital,E_28days,352,341,47,294,47 (13.8%),11 (3.1%)
1,Pilgrim General Hospital,TOTAL,1012,974,343,631,343 (35.2%),38 (3.8%)
1,"Queen's Hospital, Burton on Trent",A_7days,194,158,78,80,78 (49.4%),36 (18.6%)
1,"Queen's Hospital, Burton on Trent",B_8_14days,318,248,109,139,109 (44%),70 (22%)
1,"Queen's Hospital, Burton on Trent",C_15_21days,473,372,126,246,126 (33.9%),101 (21.4%)
1,"Queen's Hospital, Burton on Trent",D_22_28days,337,242,89,153,89 (36.8%),95 (28.2%)
1,"Queen's Hospital, Burton on Trent",E_28days,462,375,50,325,50 (13.3%),87 (18.8%)
1,"Queen's Hospital, Burton on Trent",TOTAL,1784,1395,452,943,452 (32.4%),389 (21.8%)
1,Bedford Hospital,A_7days,150,144,125,19,125 (86.8%),6 (4%)
1,Bedford Hospital,B_8_14days,398,362,283,79,283 (78.2%),36 (9%)
1,Bedford Hospital,C_15_21days,467,442,313,129,313 (70.8%),25 (5.4%)
1,Bedford Hospital,D_22_28days,398,372,259,113,259 (69.6%),26 (6.5%)
1,Bedford Hospital,E_28days,898,826,541,285,541 (65.5%),72 (8%)
1,Bedford Hospital,TOTAL,2311,2146,1521,625,1521 (70.9%),165 (7.1%)
1,Hinchingbrooke Hospital,A_7days,115,108,74,34,74 (68.5%),7 (6.1%)
1,Hinchingbrooke Hospital,B_8_14days,363,347,179,168,179 (51.6%),16 (4.4%)
1,Hinchingbrooke Hospital,C_15_21days,356,350,184,166,184 (52.6%),6 (1.7%)
1,Hinchingbrooke Hospital,D_22_28days,136,126,60,66,60 (47.6%),10 (7.4%)
1,Hinchingbrooke Hospital,E_28days,587,560,171,389,171 (30.5%),27 (4.6%)
1,Hinchingbrooke Hospital,TOTAL,1557,1491,668,823,668 (44.8%),66 (4.2%)
1,James Paget Hospital,A_7days,185,185,88,97,88 (47.6%),0 (0%)
1,James Paget Hospital,B_8_14days,182,181,60,121,60 (33.1%),1 (.5%)
1,James Paget Hospital,C_15_21days,157,157,47,110,47 (29.9%),0 (0%)
1,James Paget Hospital,D_22_28days,160,160,38,122,38 (23.8%),0 (0%)
1,James Paget Hospital,E_28days,963,959,237,722,237 (24.7%),4 (.4%)
1,James Paget Hospital,TOTAL,1647,1642,470,1172,470 (28.6%),5 (.3%)
1,West Suffolk Hospital,A_7days,166,166,111,55,111 (66.9%),0 (0%)
1,West Suffolk Hospital,B_8_14days,284,284,165,119,165 (58.1%),0 (0%)
1,West Suffolk Hospital,C_15_21days,405,405,161,244,161 (39.8%),0 (0%)
1,West Suffolk Hospital,D_22_28days,226,226,90,136,90 (39.8%),0 (0%)
1,West Suffolk Hospital,E_28days,598,579,283,296,283 (48.9%),19 (3.2%)
1,West Suffolk Hospital,TOTAL,1679,1660,810,850,810 (48.8%),19 (1.1%)
1,Conquest Hospital,A_7days,269,257,31,226,31 (12.1%),12 (4.5%)
1,Conquest Hospital,B_8_14days,471,462,37,425,37 (8%),9 (1.9%)
1,Conquest Hospital,C_15_21days,389,381,32,349,32 (8.4%),8 (2.1%)
1,Conquest Hospital,D_22_28days,265,259,19,240,19 (7.3%),6 (2.3%)
1,Conquest Hospital,E_28days,313,303,22,281,22 (7.3%),10 (3.2%)
1,Conquest Hospital,TOTAL,1707,1662,141,1521,141 (8.5%),45 (2.6%)
1,Darent Valley Hospital,A_7days,271,240,166,74,166 (69.2%),31 (11.4%)
1,Darent Valley Hospital,B_8_14days,800,711,305,406,305 (42.9%),89 (11.1%)
1,Darent Valley Hospital,C_15_21days,835,742,245,497,245 (33%),93 (11.1%)
1,Darent Valley Hospital,D_22_28days,726,640,256,384,256 (40%),86 (11.8%)
1,Darent Valley Hospital,E_28days,1630,1437,511,926,511 (35.6%),193 (11.8%)
1,Darent Valley Hospital,TOTAL,4262,3770,1483,2287,1483 (39.3%),492 (11.5%)
1,"Princess Royal Hospital, Haywards Heath",A_7days,177,167,85,82,85 (50.9%),10 (5.6%)
1,"Princess Royal Hospital, Haywards Heath",B_8_14days,273,253,104,149,104 (41.1%),20 (7.3%)
1,"Princess Royal Hospital, Haywards Heath",C_15_21days,357,338,165,173,165 (48.8%),19 (5.3%)
1,"Princess Royal Hospital, Haywards Heath",D_22_28days,136,122,43,79,43 (35.2%),14 (10.3%)
1,"Princess Royal Hospital, Haywards Heath",E_28days,436,405,156,249,156 (38.5%),31 (7.1%)
1,"Princess Royal Hospital, Haywards Heath",TOTAL,1379,1285,553,732,553 (43%),94 (6.8%)
1,Queen Elizabeth The Queen Mother Hospital,A_7days,244,232,113,119,113 (48.7%),12 (4.9%)
1,Queen Elizabeth The Queen Mother Hospital,B_8_14days,307,304,110,194,110 (36.2%),3 (1%)
1,Queen Elizabeth The Queen Mother Hospital,C_15_21days,418,415,111,304,111 (26.7%),3 (.7%)
1,Queen Elizabeth The Queen Mother Hospital,D_22_28days,434,428,115,313,115 (26.9%),6 (1.4%)
1,Queen Elizabeth The Queen Mother Hospital,E_28days,294,294,67,227,67 (22.8%),0 (0%)
1,Queen Elizabeth The Queen Mother Hospital,TOTAL,1697,1673,516,1157,516 (30.8%),24 (1.4%)
1,Royal Surrey County Hospital,A_7days,210,209,54,155,54 (25.8%),1 (.5%)
1,Royal Surrey County Hospital,B_8_14days,336,336,75,261,75 (22.3%),0 (0%)
1,Royal Surrey County Hospital,C_15_21days,191,191,41,150,41 (21.5%),0 (0%)
1,Royal Surrey County Hospital,D_22_28days,254,254,45,209,45 (17.7%),0 (0%)
1,Royal Surrey County Hospital,E_28days,230,230,57,173,57 (24.8%),0 (0%)
1,Royal Surrey County Hospital,TOTAL,1221,1220,272,948,272 (22.3%),1 (.1%)
1,Worthing Hospital,A_7days,141,136,20,116,20 (14.7%),5 (3.5%)
1,Worthing Hospital,B_8_14days,367,364,60,304,60 (16.5%),3 (.8%)
1,Worthing Hospital,C_15_21days,344,340,46,294,46 (13.5%),4 (1.2%)
1,Worthing Hospital,D_22_28days,452,437,48,389,48 (11%),15 (3.3%)
1,Worthing Hospital,E_28days,505,496,53,443,53 (10.7%),9 (1.8%)
1,Worthing Hospital,TOTAL,1809,1773,227,1546,227 (12.8%),36 (2%)
1,Royal Free Hospital,,,,,,,
1,Royal Free Hospital,,,,,,,
1,Royal Free Hospital,,,,,,,
1,Royal Free Hospital,,,,,,,
1,Royal Free Hospital,,,,,,,
1,Royal Free Hospital,,,,,,,
1,West Middlesex University Hospital,A_7days,397,333,252,81,252 (75.7%),64 (16.1%)
1,West Middlesex University Hospital,B_8_14days,690,557,340,217,340 (61%),133 (19.3%)
1,West Middlesex University Hospital,C_15_21days,749,641,323,318,323 (50.4%),108 (14.4%)
1,West Middlesex University Hospital,D_22_28days,567,449,290,159,290 (64.6%),118 (20.8%)
1,West Middlesex University Hospital,E_28days,1610,1379,708,671,708 (51.3%),231 (14.3%)
1,West Middlesex University Hospital,TOTAL,4013,3359,1913,1446,1913 (57%),654 (16.3%)
1,Epsom General Hospital,A_7days,104,103,6,97,6 (5.8%),1 (1%)
1,Epsom General Hospital,B_8_14days,108,103,0,103,0 (0%),5 (4.6%)
1,Epsom General Hospital,C_15_21days,127,123,4,119,4 (3.3%),4 (3.1%)
1,Epsom General Hospital,D_22_28days,66,66,3,63,3 (4.5%),0 (0%)
1,Epsom General Hospital,TOTAL,405,395,13,382,13 (3.3%),10 (2.5%)
1,Furness General Hospital,A_7days,28,23,16,7,16 (69.6%),5 (17.9%)
1,Furness General Hospital,B_8_14days,126,92,56,36,56 (60.9%),34 (27%)
1,Furness General Hospital,C_15_21days,107,98,49,49,49 (50%),9 (8.4%)
1,Furness General Hospital,D_22_28days,165,156,88,68,88 (56.4%),9 (5.5%)
1,Furness General Hospital,E_28days,191,174,84,90,84 (48.3%),17 (8.9%)
1,Furness General Hospital,TOTAL,617,543,293,250,293 (54%),74 (12%)
1,Macclesfield District General Hospital,A_7days,37,37,21,16,21 (56.8%),0 (0%)
1,Macclesfield District General Hospital,B_8_14days,38,38,14,24,14 (36.8%),0 (0%)
1,Macclesfield District General Hospital,C_15_21days,45,44,14,30,14 (31.8%),1 (2.2%)
1,Macclesfield District General Hospital,TOTAL,120,119,49,70,49 (41.2%),1 (.8%)
1,Cumberland Infirmary,A_7days,114,109,40,69,40 (36.7%),5 (4.4%)
1,Cumberland Infirmary,B_8_14days,287,264,96,168,96 (36.4%),23 (8%)
1,Cumberland Infirmary,C_15_21days,182,177,43,134,43 (24.3%),5 (2.7%)
1,Cumberland Infirmary,D_22_28days,207,188,56,132,56 (29.8%),19 (9.2%)
1,Cumberland Infirmary,E_28days,131,125,26,99,26 (20.8%),6 (4.6%)
1,Cumberland Infirmary,TOTAL,921,863,261,602,261 (30.2%),58 (6.3%)
1,Darlington Memorial Hospital,A_7days,91,85,34,51,34 (40%),6 (6.6%)
1,Darlington Memorial Hospital,B_8_14days,168,158,65,93,65 (41.1%),10 (6%)
1,Darlington Memorial Hospital,C_15_21days,171,164,86,78,86 (52.4%),7 (4.1%)
1,Darlington Memorial Hospital,D_22_28days,275,252,124,128,124 (49.2%),23 (8.4%)
1,Darlington Memorial Hospital,E_28days,412,379,169,210,169 (44.6%),33 (8%)
1,Darlington Memorial Hospital,TOTAL,1117,1038,478,560,478 (46.1%),79 (7.1%)
1,Northumbria Specialist Emergency Care Hospital,A_7days,142,136,59,77,59 (43.4%),6 (4.2%)
1,Northumbria Specialist Emergency Care Hospital,B_8_14days,340,321,146,175,146 (45.5%),19 (5.6%)
1,Northumbria Specialist Emergency Care Hospital,C_15_21days,516,494,196,298,196 (39.7%),22 (4.3%)
1,Northumbria Specialist Emergency Care Hospital,D_22_28days,433,427,187,240,187 (43.8%),6 (1.4%)
1,Northumbria Specialist Emergency Care Hospital,E_28days,452,452,204,248,204 (45.1%),0 (0%)
1,Northumbria Specialist Emergency Care Hospital,TOTAL,1883,1830,792,1038,792 (43.3%),53 (2.8%)
1,"Queen Elizabeth Hospital, Gateshead",A_7days,121,119,22,97,22 (18.5%),2 (1.7%)
1,"Queen Elizabeth Hospital, Gateshead",B_8_14days,237,236,37,199,37 (15.7%),1 (.4%)
1,"Queen Elizabeth Hospital, Gateshead",C_15_21days,292,292,28,264,28 (9.6%),0 (0%)
1,"Queen Elizabeth Hospital, Gateshead",D_22_28days,263,263,26,237,26 (9.9%),0 (0%)
1,"Queen Elizabeth Hospital, Gateshead",E_28days,607,597,46,551,46 (7.7%),10 (1.6%)
1,"Queen Elizabeth Hospital, Gateshead",TOTAL,1520,1507,159,1348,159 (10.6%),13 (.9%)
1,University Hospital of North Durham,A_7days,168,138,65,73,65 (47.1%),30 (17.9%)
1,University Hospital of North Durham,B_8_14days,253,202,84,118,84 (41.6%),51 (20.2%)
1,University Hospital of North Durham,C_15_21days,288,234,83,151,83 (35.5%),54 (18.8%)
1,University Hospital of North Durham,D_22_28days,257,243,50,193,50 (20.6%),14 (5.4%)
1,University Hospital of North Durham,E_28days,643,523,97,426,97 (18.5%),120 (18.7%)
1,University Hospital of North Durham,TOTAL,1609,1340,379,961,379 (28.3%),269 (16.7%)
1,University Hospital of North Tees,A_7days,181,159,105,54,105 (66%),22 (12.2%)
1,University Hospital of North Tees,B_8_14days,514,439,231,208,231 (52.6%),75 (14.6%)
1,University Hospital of North Tees,C_15_21days,386,363,142,221,142 (39.1%),23 (6%)
1,University Hospital of North Tees,D_22_28days,301,286,143,143,143 (50%),15 (5%)
1,University Hospital of North Tees,E_28days,627,579,185,394,185 (32%),48 (7.7%)
1,University Hospital of North Tees,TOTAL,2009,1826,806,1020,806 (44.1%),183 (9.1%)
1,West Cumberland Hospital,A_7days,71,59,35,24,35 (59.3%),12 (16.9%)
1,West Cumberland Hospital,B_8_14days,221,186,71,115,71 (38.2%),35 (15.8%)
1,West Cumberland Hospital,C_15_21days,147,122,41,81,41 (33.6%),25 (17%)
1,West Cumberland Hospital,D_22_28days,169,134,24,110,24 (17.9%),35 (20.7%)
1,West Cumberland Hospital,E_28days,97,86,15,71,15 (17.4%),11 (11.3%)
1,West Cumberland Hospital,TOTAL,705,587,186,401,186 (31.7%),118 (16.7%)
1,"Borders General Hospital, Melrose",A_7days,56,35,14,21,14 (40%),21 (37.5%)
1,"Borders General Hospital, Melrose",B_8_14days,104,64,21,43,21 (32.8%),40 (38.5%)
1,"Borders General Hospital, Melrose",C_15_21days,80,37,9,28,9 (24.3%),43 (53.8%)
1,"Borders General Hospital, Melrose",D_22_28days,93,77,18,59,18 (23.4%),16 (17.2%)
1,"Borders General Hospital, Melrose",E_28days,629,400,61,339,61 (15.3%),229 (36.4%)
1,"Borders General Hospital, Melrose",TOTAL,962,613,123,490,123 (20.1%),349 (36.3%)
1,Dumfries & Galloway Royal Infirmary,A_7days,120,116,42,74,42 (36.2%),4 (3.3%)
1,Dumfries & Galloway Royal Infirmary,B_8_14days,158,157,38,119,38 (24.2%),1 (.6%)
1,Dumfries & Galloway Royal Infirmary,C_15_21days,218,206,45,161,45 (21.8%),12 (5.5%)
1,Dumfries & Galloway Royal Infirmary,D_22_28days,282,251,66,185,66 (26.3%),31 (11%)
1,Dumfries & Galloway Royal Infirmary,E_28days,421,403,40,363,40 (9.9%),18 (4.3%)
1,Dumfries & Galloway Royal Infirmary,TOTAL,1199,1133,231,902,231 (20.4%),66 (5.5%)
1,"St John's Hospital, Livingston",A_7days,141,134,17,117,17 (12.7%),7 (5%)
1,"St John's Hospital, Livingston",B_8_14days,223,215,7,208,7 (3.3%),8 (3.6%)
1,"St John's Hospital, Livingston",C_15_21days,189,189,9,180,9 (4.8%),0 (0%)
1,"St John's Hospital, Livingston",D_22_28days,167,165,3,162,3 (1.8%),2 (1.2%)
1,"St John's Hospital, Livingston",E_28days,535,523,19,504,19 (3.6%),12 (2.2%)
1,"St John's Hospital, Livingston",TOTAL,1255,1226,55,1171,55 (4.5%),29 (2.3%)
1,North Devon District Hospital,A_7days,105,97,38,59,38 (39.2%),8 (7.6%)
1,North Devon District Hospital,B_8_14days,177,172,89,83,89 (51.7%),5 (2.8%)
1,North Devon District Hospital,C_15_21days,223,216,98,118,98 (45.4%),7 (3.1%)
1,North Devon District Hospital,D_22_28days,129,129,50,79,50 (38.8%),0 (0%)
1,North Devon District Hospital,E_28days,384,375,180,195,180 (48%),9 (2.3%)
1,North Devon District Hospital,TOTAL,1018,989,455,534,455 (46%),29 (2.8%)
1,Torbay Hospital,A_7days,217,193,114,79,114 (59.1%),24 (11.1%)
1,Torbay Hospital,B_8_14days,357,299,162,137,162 (54.2%),58 (16.2%)
1,Torbay Hospital,C_15_21days,324,298,125,173,125 (41.9%),26 (8%)
1,Torbay Hospital,D_22_28days,203,176,84,92,84 (47.7%),27 (13.3%)
1,Torbay Hospital,E_28days,551,480,147,333,147 (30.6%),71 (12.9%)
1,Torbay Hospital,TOTAL,1652,1446,632,814,632 (43.7%),206 (12.5%)
1,Yeovil District Hospital,A_7days,148,125,47,78,47 (37.6%),23 (15.5%)
1,Yeovil District Hospital,B_8_14days,125,103,30,73,30 (29.1%),22 (17.6%)
1,Yeovil District Hospital,C_15_21days,289,240,56,184,56 (23.3%),49 (17%)
1,Yeovil District Hospital,D_22_28days,259,216,43,173,43 (19.9%),43 (16.6%)
1,Yeovil District Hospital,E_28days,329,257,57,200,57 (22.2%),72 (21.9%)
1,Yeovil District Hospital,TOTAL,1150,941,233,708,233 (24.8%),209 (18.2%)
1,Dorset County Hospital,A_7days,71,61,32,29,32 (52.5%),10 (14.1%)
1,Dorset County Hospital,B_8_14days,183,145,54,91,54 (37.2%),38 (20.8%)
1,Dorset County Hospital,C_15_21days,152,117,19,98,19 (16.2%),35 (23%)
1,Dorset County Hospital,D_22_28days,178,152,21,131,21 (13.8%),26 (14.6%)
1,Dorset County Hospital,E_28days,299,267,42,225,42 (15.7%),32 (10.7%)
1,Dorset County Hospital,TOTAL,883,742,168,574,168 (22.6%),141 (16%)
1,"St Mary's Hospital, Isle of Wight",A_7days,85,84,27,57,27 (32.1%),1 (1.2%)
1,"St Mary's Hospital, Isle of Wight",B_8_14days,87,86,12,74,12 (14%),1 (1.1%)
1,"St Mary's Hospital, Isle of Wight",C_15_21days,119,119,27,92,27 (22.7%),0 (0%)
1,"St Mary's Hospital, Isle of Wight",D_22_28days,98,97,17,80,17 (17.5%),1 (1%)
1,"St Mary's Hospital, Isle of Wight",E_28days,173,172,39,133,39 (22.7%),1 (.6%)
1,"St Mary's Hospital, Isle of Wight",TOTAL,562,558,122,436,122 (21.9%),4 (.7%)
1,Glangwili General Hospital,A_7days,207,170,84,86,84 (49.4%),37 (17.9%)
1,Glangwili General Hospital,B_8_14days,374,339,174,165,174 (51.3%),35 (9.4%)
1,Glangwili General Hospital,C_15_21days,422,367,157,210,157 (42.8%),55 (13%)
1,Glangwili General Hospital,D_22_28days,472,396,203,193,203 (51.3%),76 (16.1%)
1,Glangwili General Hospital,E_28days,631,545,205,340,205 (37.6%),86 (13.6%)
1,Glangwili General Hospital,TOTAL,2106,1817,823,994,823 (45.3%),289 (13.7%)
1,"Princess of Wales Hospital, Bridgend",A_7days,224,182,88,94,88 (48.4%),42 (18.8%)
1,"Princess of Wales Hospital, Bridgend",B_8_14days,289,244,120,124,120 (49.2%),45 (15.6%)
1,"Princess of Wales Hospital, Bridgend",C_15_21days,420,366,125,241,125 (34.2%),54 (12.9%)
1,"Princess of Wales Hospital, Bridgend",D_22_28days,404,344,115,229,115 (33.4%),60 (14.9%)
1,"Princess of Wales Hospital, Bridgend",E_28days,537,465,155,310,155 (33.3%),72 (13.4%)
1,"Princess of Wales Hospital, Bridgend",TOTAL,1874,1601,603,998,603 (37.7%),273 (14.6%)
1,Wrexham Maelor Hospital,A_7days,119,111,68,43,68 (61.3%),8 (6.7%)
1,Wrexham Maelor Hospital,B_8_14days,264,226,112,114,112 (49.6%),38 (14.4%)
1,Wrexham Maelor Hospital,C_15_21days,388,341,124,217,124 (36.4%),47 (12.1%)
1,Wrexham Maelor Hospital,D_22_28days,291,253,143,110,143 (56.5%),38 (13.1%)
1,Wrexham Maelor Hospital,E_28days,1121,1058,643,415,643 (60.8%),63 (5.6%)
1,Wrexham Maelor Hospital,TOTAL,2183,1989,1090,899,1090 (54.8%),194 (8.9%)
1,Ysbyty Gwynedd,A_7days,158,142,50,92,50 (35.2%),16 (10.1%)
1,Ysbyty Gwynedd,B_8_14days,105,96,26,70,26 (27.1%),9 (8.6%)
1,Ysbyty Gwynedd,C_15_21days,208,189,38,151,38 (20.1%),19 (9.1%)
1,Ysbyty Gwynedd,D_22_28days,259,245,57,188,57 (23.3%),14 (5.4%)
1,Ysbyty Gwynedd,E_28days,358,348,104,244,104 (29.9%),10 (2.8%)
1,Ysbyty Gwynedd,TOTAL,1088,1020,275,745,275 (27%),68 (6.3%)
1,George Eliot Hospital,A_7days,206,195,139,56,139 (71.3%),11 (5.3%)
1,George Eliot Hospital,B_8_14days,345,313,167,146,167 (53.4%),32 (9.3%)
1,George Eliot Hospital,C_15_21days,440,403,214,189,214 (53.1%),37 (8.4%)
1,George Eliot Hospital,D_22_28days,226,211,86,125,86 (40.8%),15 (6.6%)
1,George Eliot Hospital,E_28days,355,315,77,238,77 (24.4%),40 (11.3%)
1,George Eliot Hospital,TOTAL,1572,1437,683,754,683 (47.5%),135 (8.6%)
1,Good Hope Hospital,A_7days,210,187,63,124,63 (33.7%),23 (11%)
1,Good Hope Hospital,B_8_14days,507,420,103,317,103 (24.5%),87 (17.2%)
1,Good Hope Hospital,C_15_21days,409,366,75,291,75 (20.5%),43 (10.5%)
1,Good Hope Hospital,D_22_28days,682,620,119,501,119 (19.2%),62 (9.1%)
1,Good Hope Hospital,E_28days,924,836,102,734,102 (12.2%),88 (9.5%)
1,Good Hope Hospital,TOTAL,2732,2429,462,1967,462 (19%),303 (11.1%)
1,Hereford County Hospital,A_7days,172,157,133,24,133 (84.7%),15 (8.7%)
1,Hereford County Hospital,B_8_14days,353,328,225,103,225 (68.6%),25 (7.1%)
1,Hereford County Hospital,C_15_21days,277,258,160,98,160 (62%),19 (6.9%)
1,Hereford County Hospital,D_22_28days,89,88,35,53,35 (39.8%),1 (1.1%)
1,Hereford County Hospital,E_28days,691,649,416,233,416 (64.1%),42 (6.1%)
1,Hereford County Hospital,TOTAL,1582,1480,969,511,969 (65.5%),102 (6.4%)
1,Warwick Hospital,A_7days,197,197,48,149,48 (24.4%),0 (0%)
1,Warwick Hospital,B_8_14days,449,449,92,357,92 (20.5%),0 (0%)
1,Warwick Hospital,C_15_21days,315,315,40,275,40 (12.7%),0 (0%)
1,Warwick Hospital,D_22_28days,251,251,27,224,27 (10.8%),0 (0%)
1,Warwick Hospital,E_28days,470,470,48,422,48 (10.2%),0 (0%)
1,Warwick Hospital,TOTAL,1682,1682,255,1427,255 (15.2%),0 (0%)
1,Airedale General Hospital,A_7days,140,137,75,62,75 (54.7%),3 (2.1%)
1,Airedale General Hospital,B_8_14days,445,441,237,204,237 (53.7%),4 (.9%)
1,Airedale General Hospital,C_15_21days,325,323,109,214,109 (33.7%),2 (.6%)
1,Airedale General Hospital,D_22_28days,349,344,119,225,119 (34.6%),5 (1.4%)
1,Airedale General Hospital,E_28days,736,723,206,517,206 (28.5%),13 (1.8%)
1,Airedale General Hospital,TOTAL,1995,1968,746,1222,746 (37.9%),27 (1.4%)
1,Bassetlaw District General Hospital,A_7days,72,72,43,29,43 (59.7%),0 (0%)
1,Bassetlaw District General Hospital,B_8_14days,172,172,79,93,79 (45.9%),0 (0%)
1,Bassetlaw District General Hospital,C_15_21days,323,323,135,188,135 (41.8%),0 (0%)
1,Bassetlaw District General Hospital,D_22_28days,181,181,41,140,41 (22.7%),0 (0%)
1,Bassetlaw District General Hospital,E_28days,246,246,71,175,71 (28.9%),0 (0%)
1,Bassetlaw District General Hospital,TOTAL,994,994,369,625,369 (37.1%),0 (0%)
1,Harrogate District Hospital,A_7days,53,52,18,34,18 (34.6%),1 (1.9%)
1,Harrogate District Hospital,B_8_14days,203,194,55,139,55 (28.4%),9 (4.4%)
1,Harrogate District Hospital,C_15_21days,136,133,23,110,23 (17.3%),3 (2.2%)
1,Harrogate District Hospital,D_22_28days,296,273,51,222,51 (18.7%),23 (7.8%)
1,Harrogate District Hospital,E_28days,448,429,106,323,106 (24.7%),19 (4.2%)
1,Harrogate District Hospital,TOTAL,1136,1081,253,828,253 (23.4%),55 (4.8%)
1,Scarborough General Hospital,A_7days,95,88,66,22,66 (75%),7 (7.4%)
1,Scarborough General Hospital,B_8_14days,156,138,91,47,91 (65.9%),18 (11.5%)
1,Scarborough General Hospital,C_15_21days,345,330,194,136,194 (58.8%),15 (4.3%)
1,Scarborough General Hospital,D_22_28days,228,214,118,96,118 (55.1%),14 (6.1%)
1,Scarborough General Hospital,E_28days,185,173,71,102,71 (41%),12 (6.5%)
1,Scarborough General Hospital,TOTAL,1009,943,540,403,540 (57.3%),66 (6.5%)
2,Kettering General Hospital,A_7days,305,294,145,149,145 (49.3%),11 (3.6%)
2,Kettering General Hospital,B_8_14days,525,495,215,280,215 (43.4%),30 (5.7%)
2,Kettering General Hospital,C_15_21days,575,556,196,360,196 (35.3%),19 (3.3%)
2,Kettering General Hospital,D_22_28days,348,321,143,178,143 (44.5%),27 (7.8%)
2,Kettering General Hospital,E_28days,1527,1424,527,897,527 (37%),103 (6.7%)
2,Kettering General Hospital,TOTAL,3280,3090,1226,1864,1226 (39.7%),190 (5.8%)
2,King's Mill Hospital,A_7days,180,166,72,94,72 (43.4%),14 (7.8%)
2,King's Mill Hospital,B_8_14days,360,303,136,167,136 (44.9%),57 (15.8%)
2,King's Mill Hospital,C_15_21days,386,338,134,204,134 (39.6%),48 (12.4%)
2,King's Mill Hospital,D_22_28days,376,339,140,199,140 (41.3%),37 (9.8%)
2,King's Mill Hospital,E_28days,2113,1868,603,1265,603 (32.3%),245 (11.6%)
2,King's Mill Hospital,TOTAL,3415,3014,1085,1929,1085 (36%),401 (11.7%)
2,Lincoln County Hospital,A_7days,254,224,124,100,124 (55.4%),30 (11.8%)
2,Lincoln County Hospital,B_8_14days,292,267,127,140,127 (47.6%),25 (8.6%)
2,Lincoln County Hospital,C_15_21days,450,364,169,195,169 (46.4%),86 (19.1%)
2,Lincoln County Hospital,D_22_28days,371,325,121,204,121 (37.2%),46 (12.4%)
2,Lincoln County Hospital,E_28days,1718,1440,589,851,589 (40.9%),278 (16.2%)
2,Lincoln County Hospital,TOTAL,3085,2620,1130,1490,1130 (43.1%),465 (15.1%)
2,Northampton General Hospital,A_7days,270,261,152,109,152 (58.2%),9 (3.3%)
2,Northampton General Hospital,B_8_14days,571,560,298,262,298 (53.2%),11 (1.9%)
2,Northampton General Hospital,C_15_21days,632,625,258,367,258 (41.3%),7 (1.1%)
2,Northampton General Hospital,D_22_28days,663,647,230,417,230 (35.5%),16 (2.4%)
2,Northampton General Hospital,E_28days,1665,1635,637,998,637 (39%),30 (1.8%)
2,Northampton General Hospital,TOTAL,3801,3728,1575,2153,1575 (42.2%),73 (1.9%)
2,Royal Derby Hospital,A_7days,336,304,108,196,108 (35.5%),32 (9.5%)
2,Royal Derby Hospital,B_8_14days,534,481,101,380,101 (21%),53 (9.9%)
2,Royal Derby Hospital,C_15_21days,937,831,129,702,129 (15.5%),106 (11.3%)
2,Royal Derby Hospital,D_22_28days,701,621,108,513,108 (17.4%),80 (11.4%)
2,Royal Derby Hospital,E_28days,3699,3364,480,2884,480 (14.3%),335 (9.1%)
2,Royal Derby Hospital,TOTAL,6207,5601,926,4675,926 (16.5%),606 (9.8%)
2,Basildon University Hospital,A_7days,418,417,276,141,276 (66.2%),1 (.2%)
2,Basildon University Hospital,B_8_14days,551,551,245,306,245 (44.5%),0 (0%)
2,Basildon University Hospital,C_15_21days,444,444,161,283,161 (36.3%),0 (0%)
2,Basildon University Hospital,D_22_28days,383,383,144,239,144 (37.6%),0 (0%)
2,Basildon University Hospital,E_28days,1946,1942,831,1111,831 (42.8%),4 (.2%)
2,Basildon University Hospital,TOTAL,3742,3737,1657,2080,1657 (44.3%),5 (.1%)
2,"Broomfield Hospital, Chelmsford",A_7days,359,266,145,121,145 (54.5%),93 (25.9%)
2,"Broomfield Hospital, Chelmsford",B_8_14days,733,569,267,302,267 (46.9%),164 (22.4%)
2,"Broomfield Hospital, Chelmsford",C_15_21days,598,438,150,288,150 (34.2%),160 (26.8%)
2,"Broomfield Hospital, Chelmsford",D_22_28days,377,247,93,154,93 (37.7%),130 (34.5%)
2,"Broomfield Hospital, Chelmsford",E_28days,1670,991,414,577,414 (41.8%),679 (40.7%)
2,"Broomfield Hospital, Chelmsford",TOTAL,3737,2511,1069,1442,1069 (42.6%),1226 (32.8%)
2,Colchester General Hospital,A_7days,410,386,221,165,221 (57.3%),24 (5.9%)
2,Colchester General Hospital,B_8_14days,686,644,363,281,363 (56.4%),42 (6.1%)
2,Colchester General Hospital,C_15_21days,235,216,107,109,107 (49.5%),19 (8.1%)
2,Colchester General Hospital,D_22_28days,451,434,136,298,136 (31.3%),17 (3.8%)
2,Colchester General Hospital,E_28days,748,693,186,507,186 (26.8%),55 (7.4%)
2,Colchester General Hospital,TOTAL,2530,2373,1013,1360,1013 (42.7%),157 (6.2%)
2,Ipswich Hospital,A_7days,476,435,328,107,328 (75.4%),41 (8.6%)
2,Ipswich Hospital,B_8_14days,660,611,368,243,368 (60.2%),49 (7.4%)
2,Ipswich Hospital,C_15_21days,349,324,181,143,181 (55.9%),25 (7.2%)
2,Ipswich Hospital,D_22_28days,317,288,86,202,86 (29.9%),29 (9.1%)
2,Ipswich Hospital,E_28days,1574,1396,686,710,686 (49.1%),178 (11.3%)
2,Ipswich Hospital,TOTAL,3376,3054,1649,1405,1649 (54%),322 (9.5%)
2,Lister Hospital,A_7days,349,338,205,133,205 (60.7%),11 (3.2%)
2,Lister Hospital,B_8_14days,641,625,345,280,345 (55.2%),16 (2.5%)
2,Lister Hospital,C_15_21days,888,848,345,503,345 (40.7%),40 (4.5%)
2,Lister Hospital,D_22_28days,594,557,220,337,220 (39.5%),37 (6.2%)
2,Lister Hospital,E_28days,1599,1546,760,786,760 (49.2%),53 (3.3%)
2,Lister Hospital,TOTAL,4071,3914,1875,2039,1875 (47.9%),157 (3.9%)
2,Peterborough City Hospital,A_7days,231,183,78,105,78 (42.6%),48 (20.8%)
2,Peterborough City Hospital,B_8_14days,395,338,119,219,119 (35.2%),57 (14.4%)
2,Peterborough City Hospital,C_15_21days,373,323,71,252,71 (22%),50 (13.4%)
2,Peterborough City Hospital,D_22_28days,287,238,55,183,55 (23.1%),49 (17.1%)
2,Peterborough City Hospital,E_28days,2790,2472,542,1930,542 (21.9%),318 (11.4%)
2,Peterborough City Hospital,TOTAL,4076,3554,865,2689,865 (24.3%),522 (12.8%)
2,Princess Alexandra Hospital,A_7days,301,231,127,104,127 (55%),70 (23.3%)
2,Princess Alexandra Hospital,B_8_14days,719,513,218,295,218 (42.5%),206 (28.7%)
2,Princess Alexandra Hospital,C_15_21days,470,310,136,174,136 (43.9%),160 (34%)
2,Princess Alexandra Hospital,D_22_28days,519,393,118,275,118 (30%),126 (24.3%)
2,Princess Alexandra Hospital,E_28days,1864,1198,449,749,449 (37.5%),666 (35.7%)
2,Princess Alexandra Hospital,TOTAL,3873,2645,1048,1597,1048 (39.6%),1228 (31.7%)
2,"Queen Elizabeth Hospital, King's Lynn",A_7days,165,148,73,75,73 (49.3%),17 (10.3%)
2,"Queen Elizabeth Hospital, King's Lynn",B_8_14days,274,236,127,109,127 (53.8%),38 (13.9%)
2,"Queen Elizabeth Hospital, King's Lynn",C_15_21days,234,205,78,127,78 (38%),29 (12.4%)
2,"Queen Elizabeth Hospital, King's Lynn",D_22_28days,273,258,128,130,128 (49.6%),15 (5.5%)
2,"Queen Elizabeth Hospital, King's Lynn",E_28days,854,757,230,527,230 (30.4%),97 (11.4%)
2,"Queen Elizabeth Hospital, King's Lynn",TOTAL,1800,1604,636,968,636 (39.7%),196 (10.9%)
2,Southend Hospital,A_7days,233,228,152,76,152 (66.7%),5 (2.1%)
2,Southend Hospital,B_8_14days,507,461,248,213,248 (53.8%),46 (9.1%)
2,Southend Hospital,C_15_21days,363,319,164,155,164 (51.4%),44 (12.1%)
2,Southend Hospital,D_22_28days,349,322,118,204,118 (36.6%),27 (7.7%)
2,Southend Hospital,E_28days,1014,953,379,574,379 (39.8%),61 (6%)
2,Southend Hospital,TOTAL,2466,2283,1061,1222,1061 (46.5%),183 (7.4%)
2,Watford General Hospital,A_7days,248,243,101,142,101 (41.6%),5 (2%)
2,Watford General Hospital,B_8_14days,227,222,75,147,75 (33.8%),5 (2.2%)
2,Watford General Hospital,C_15_21days,216,212,67,145,67 (31.6%),4 (1.9%)
2,Watford General Hospital,D_22_28days,331,322,81,241,81 (25.2%),9 (2.7%)
2,Watford General Hospital,E_28days,1417,1373,457,916,457 (33.3%),44 (3.1%)
2,Watford General Hospital,TOTAL,2439,2372,781,1591,781 (32.9%),67 (2.7%)
2,East Surrey Hospital,A_7days,266,266,191,75,191 (71.8%),0 (0%)
2,East Surrey Hospital,B_8_14days,557,557,317,240,317 (56.9%),0 (0%)
2,East Surrey Hospital,C_15_21days,447,447,264,183,264 (59.1%),0 (0%)
2,East Surrey Hospital,D_22_28days,399,399,152,247,152 (38.1%),0 (0%)
2,East Surrey Hospital,E_28days,1947,1947,975,972,975 (50.1%),0 (0%)
2,East Surrey Hospital,TOTAL,3616,3616,1899,1717,1899 (52.5%),0 (0%)
2,Frimley Park Hospital,A_7days,229,205,134,71,134 (65.4%),24 (10.5%)
2,Frimley Park Hospital,B_8_14days,334,290,191,99,191 (65.9%),44 (13.2%)
2,Frimley Park Hospital,C_15_21days,423,358,177,181,177 (49.4%),65 (15.4%)
2,Frimley Park Hospital,D_22_28days,486,434,217,217,217 (50%),52 (10.7%)
2,Frimley Park Hospital,E_28days,1390,1246,687,559,687 (55.1%),144 (10.4%)
2,Frimley Park Hospital,TOTAL,2862,2533,1406,1127,1406 (55.5%),329 (11.5%)
2,Tunbridge Wells Hospital,A_7days,396,334,199,135,199 (59.6%),62 (15.7%)
2,Tunbridge Wells Hospital,B_8_14days,412,390,213,177,213 (54.6%),22 (5.3%)
2,Tunbridge Wells Hospital,C_15_21days,471,441,243,198,243 (55.1%),30 (6.4%)
2,Tunbridge Wells Hospital,D_22_28days,772,710,304,406,304 (42.8%),62 (8%)
2,Tunbridge Wells Hospital,E_28days,2696,2481,1057,1424,1057 (42.6%),215 (8%)
2,Tunbridge Wells Hospital,TOTAL,4747,4356,2016,2340,2016 (46.3%),391 (8.2%)
2,Barnet Hospital,A_7days,513,496,446,50,446 (89.9%),17 (3.3%)
2,Barnet Hospital,B_8_14days,889,852,747,105,747 (87.7%),37 (4.2%)
2,Barnet Hospital,C_15_21days,1151,1107,943,164,943 (85.2%),44 (3.8%)
2,Barnet Hospital,D_22_28days,865,824,687,137,687 (83.4%),41 (4.7%)
2,Barnet Hospital,E_28days,3782,3650,2882,768,2882 (79%),132 (3.5%)
2,Barnet Hospital,TOTAL,7200,6929,5705,1224,5705 (82.3%),271 (3.8%)
2,Newham University Hospital,A_7days,399,243,96,147,96 (39.5%),156 (39.1%)
2,Newham University Hospital,B_8_14days,741,462,181,281,181 (39.2%),279 (37.7%)
2,Newham University Hospital,C_15_21days,690,460,126,334,126 (27.4%),230 (33.3%)
2,Newham University Hospital,D_22_28days,546,322,121,201,121 (37.6%),224 (41%)
2,Newham University Hospital,E_28days,3222,1859,620,1239,620 (33.4%),1363 (42.3%)
2,Newham University Hospital,TOTAL,5598,3346,1144,2202,1144 (34.2%),2252 (40.2%)
2,North Middlesex University Hospital,A_7days,443,409,282,127,282 (68.9%),34 (7.7%)
2,North Middlesex University Hospital,B_8_14days,666,635,401,234,401 (63.1%),31 (4.7%)
2,North Middlesex University Hospital,C_15_21days,342,314,204,110,204 (65%),28 (8.2%)
2,North Middlesex University Hospital,D_22_28days,512,474,287,187,287 (60.5%),38 (7.4%)
2,North Middlesex University Hospital,E_28days,2322,2123,1231,892,1231 (58%),199 (8.6%)
2,North Middlesex University Hospital,TOTAL,4285,3955,2405,1550,2405 (60.8%),330 (7.7%)
2,"Queen's Hospital, Romford",A_7days,500,484,282,202,282 (58.3%),16 (3.2%)
2,"Queen's Hospital, Romford",B_8_14days,989,940,388,552,388 (41.3%),49 (5%)
2,"Queen's Hospital, Romford",C_15_21days,868,835,252,583,252 (30.2%),33 (3.8%)
2,"Queen's Hospital, Romford",D_22_28days,1016,962,324,638,324 (33.7%),54 (5.3%)
2,"Queen's Hospital, Romford",E_28days,3845,3692,1116,2576,1116 (30.2%),153 (4%)
2,"Queen's Hospital, Romford",TOTAL,7218,6913,2362,4551,2362 (34.2%),305 (4.2%)
2,Whipps Cross University Hospital,A_7days,196,182,128,54,128 (70.3%),14 (7.1%)
2,Whipps Cross University Hospital,B_8_14days,262,239,122,117,122 (51%),23 (8.8%)
2,Whipps Cross University Hospital,C_15_21days,546,483,239,244,239 (49.5%),63 (11.5%)
2,Whipps Cross University Hospital,D_22_28days,518,454,166,288,166 (36.6%),64 (12.4%)
2,Whipps Cross University Hospital,E_28days,2289,2000,586,1414,586 (29.3%),289 (12.6%)
2,Whipps Cross University Hospital,TOTAL,3811,3358,1241,2117,1241 (37%),453 (11.9%)
2,Whittington Hospital,,,,,,,
2,Whittington Hospital,,,,,,,
2,Whittington Hospital,,,,,,,
2,Whittington Hospital,,,,,,,
2,Whittington Hospital,,,,,,,
2,Whittington Hospital,,,,,,,
2,Hillingdon Hospital,A_7days,285,262,122,140,122 (46.6%),23 (8.1%)
2,Hillingdon Hospital,B_8_14days,392,373,146,227,146 (39.1%),19 (4.8%)
2,Hillingdon Hospital,C_15_21days,525,455,150,305,150 (33%),70 (13.3%)
2,Hillingdon Hospital,D_22_28days,416,378,107,271,107 (28.3%),38 (9.1%)
2,Hillingdon Hospital,E_28days,2533,2321,556,1765,556 (24%),212 (8.4%)
2,Hillingdon Hospital,TOTAL,4151,3789,1081,2708,1081 (28.5%),362 (8.7%)
2,Northwick Park Hospital ,A_7days,180,164,104,60,104 (63.4%),16 (8.9%)
2,Northwick Park Hospital ,B_8_14days,454,428,231,197,231 (54%),26 (5.7%)
2,Northwick Park Hospital ,C_15_21days,432,405,145,260,145 (35.8%),27 (6.3%)
2,Northwick Park Hospital ,D_22_28days,690,643,256,387,256 (39.8%),47 (6.8%)
2,Northwick Park Hospital ,E_28days,2428,2296,807,1489,807 (35.1%),132 (5.4%)
2,Northwick Park Hospital ,TOTAL,4184,3936,1543,2393,1543 (39.2%),248 (5.9%)
2,"St Mary's Hospital, London",A_7days,334,332,69,263,69 (20.8%),2 (.6%)
2,"St Mary's Hospital, London",B_8_14days,491,491,67,424,67 (13.6%),0 (0%)
2,"St Mary's Hospital, London",C_15_21days,489,483,72,411,72 (14.9%),6 (1.2%)
2,"St Mary's Hospital, London",D_22_28days,744,744,101,643,101 (13.6%),0 (0%)
2,"St Mary's Hospital, London",E_28days,2386,2386,232,2154,232 (9.7%),0 (0%)
2,"St Mary's Hospital, London",TOTAL,4444,4436,541,3895,541 (12.2%),8 (.2%)
2,Croydon University Hospital,A_7days,276,259,173,86,173 (66.8%),17 (6.2%)
2,Croydon University Hospital,B_8_14days,341,325,192,133,192 (59.1%),16 (4.7%)
2,Croydon University Hospital,C_15_21days,397,364,193,171,193 (53%),33 (8.3%)
2,Croydon University Hospital,D_22_28days,582,547,298,249,298 (54.5%),35 (6%)
2,Croydon University Hospital,E_28days,2502,2219,764,1455,764 (34.4%),283 (11.3%)
2,Croydon University Hospital,TOTAL,4098,3714,1620,2094,1620 (43.6%),384 (9.4%)
2,Kingston Hospital,A_7days,383,383,327,56,327 (85.4%),0 (0%)
2,Kingston Hospital,B_8_14days,316,316,262,54,262 (82.9%),0 (0%)
2,Kingston Hospital,C_15_21days,402,398,302,96,302 (75.9%),4 (1%)
2,Kingston Hospital,D_22_28days,232,229,109,120,109 (47.6%),3 (1.3%)
2,Kingston Hospital,E_28days,1597,1576,760,816,760 (48.2%),21 (1.3%)
2,Kingston Hospital,TOTAL,2930,2902,1760,1142,1760 (60.6%),28 (1%)
2,"Princess Royal University Hospital, Farnborough",A_7days,304,279,180,99,180 (64.5%),25 (8.2%)
2,"Princess Royal University Hospital, Farnborough",B_8_14days,320,278,189,89,189 (68%),42 (13.1%)
2,"Princess Royal University Hospital, Farnborough",C_15_21days,234,194,89,105,89 (45.9%),40 (17.1%)
2,"Princess Royal University Hospital, Farnborough",D_22_28days,354,298,150,148,150 (50.3%),56 (15.8%)
2,"Princess Royal University Hospital, Farnborough",E_28days,502,417,181,236,181 (43.4%),85 (16.9%)
2,"Princess Royal University Hospital, Farnborough",TOTAL,1714,1466,789,677,789 (53.8%),248 (14.5%)
2,"Queen Elizabeth Hospital, Woolwich ",A_7days,279,276,163,113,163 (59.1%),3 (1.1%)
2,"Queen Elizabeth Hospital, Woolwich ",B_8_14days,347,338,149,189,149 (44.1%),9 (2.6%)
2,"Queen Elizabeth Hospital, Woolwich ",C_15_21days,636,629,299,330,299 (47.5%),7 (1.1%)
2,"Queen Elizabeth Hospital, Woolwich ",D_22_28days,379,372,158,214,158 (42.5%),7 (1.8%)
2,"Queen Elizabeth Hospital, Woolwich ",E_28days,1223,1201,364,837,364 (30.3%),22 (1.8%)
2,"Queen Elizabeth Hospital, Woolwich ",TOTAL,2864,2816,1133,1683,1133 (40.2%),48 (1.7%)
2,St Helier Hospital,A_7days,167,165,63,102,63 (38.2%),2 (1.2%)
2,St Helier Hospital,B_8_14days,280,277,62,215,62 (22.4%),3 (1.1%)
2,St Helier Hospital,C_15_21days,410,400,51,349,51 (12.8%),10 (2.4%)
2,St Helier Hospital,D_22_28days,308,308,52,256,52 (16.9%),0 (0%)
2,St Helier Hospital,E_28days,1337,1332,184,1148,184 (13.8%),5 (.4%)
2,St Helier Hospital,TOTAL,2502,2482,412,2070,412 (16.6%),20 (.8%)
2,University Hospital Lewisham,A_7days,169,169,131,38,131 (77.5%),0 (0%)
2,University Hospital Lewisham,B_8_14days,366,366,223,143,223 (60.9%),0 (0%)
2,University Hospital Lewisham,C_15_21days,563,562,317,245,317 (56.4%),1 (.2%)
2,University Hospital Lewisham,D_22_28days,201,201,112,89,112 (55.7%),0 (0%)
2,University Hospital Lewisham,E_28days,2177,2175,861,1314,861 (39.6%),2 (.1%)
2,University Hospital Lewisham,TOTAL,3476,3473,1644,1829,1644 (47.3%),3 (.1%)
2,Noble's Hospital,A_7days,62,62,42,20,42 (67.7%),0 (0%)
2,Noble's Hospital,B_8_14days,84,84,37,47,37 (44%),0 (0%)
2,Noble's Hospital,C_15_21days,159,159,87,72,87 (54.7%),0 (0%)
2,Noble's Hospital,D_22_28days,105,105,35,70,35 (33.3%),0 (0%)
2,Noble's Hospital,E_28days,114,114,55,59,55 (48.2%),0 (0%)
2,Noble's Hospital,TOTAL,524,524,256,268,256 (48.9%),0 (0%)
2,Countess of Chester Hospital,A_7days,88,88,51,37,51 (58%),0 (0%)
2,Countess of Chester Hospital,B_8_14days,317,315,146,169,146 (46.3%),2 (.6%)
2,Countess of Chester Hospital,C_15_21days,404,398,175,223,175 (44%),6 (1.5%)
2,Countess of Chester Hospital,D_22_28days,397,393,191,202,191 (48.6%),4 (1%)
2,Countess of Chester Hospital,E_28days,485,481,246,235,246 (51.1%),4 (.8%)
2,Countess of Chester Hospital,TOTAL,1691,1675,809,866,809 (48.3%),16 (.9%)
2,Leighton Hospital,A_7days,133,115,45,70,45 (39.1%),18 (13.5%)
2,Leighton Hospital,B_8_14days,428,367,142,225,142 (38.7%),61 (14.3%)
2,Leighton Hospital,C_15_21days,690,573,204,369,204 (35.6%),117 (17%)
2,Leighton Hospital,D_22_28days,268,245,85,160,85 (34.7%),23 (8.6%)
2,Leighton Hospital,E_28days,1334,1181,400,781,400 (33.9%),153 (11.5%)
2,Leighton Hospital,TOTAL,2853,2481,876,1605,876 (35.3%),372 (13%)
2,North Manchester General Hospital,A_7days,304,273,77,196,77 (28.2%),31 (10.2%)
2,North Manchester General Hospital,B_8_14days,670,626,183,443,183 (29.2%),44 (6.6%)
2,North Manchester General Hospital,C_15_21days,559,525,92,433,92 (17.5%),34 (6.1%)
2,North Manchester General Hospital,D_22_28days,287,272,48,224,48 (17.6%),15 (5.2%)
2,North Manchester General Hospital,E_28days,1856,1730,319,1411,319 (18.4%),126 (6.8%)
2,North Manchester General Hospital,TOTAL,3676,3426,719,2707,719 (21%),250 (6.8%)
2,Ormskirk District General Hospital,A_7days,153,148,83,65,83 (56.1%),5 (3.3%)
2,Ormskirk District General Hospital,B_8_14days,266,254,123,131,123 (48.4%),12 (4.5%)
2,Ormskirk District General Hospital,C_15_21days,284,275,105,170,105 (38.2%),9 (3.2%)
2,Ormskirk District General Hospital,D_22_28days,139,127,48,79,48 (37.8%),12 (8.6%)
2,Ormskirk District General Hospital,E_28days,1070,1011,384,627,384 (38%),59 (5.5%)
2,Ormskirk District General Hospital,TOTAL,1912,1815,743,1072,743 (40.9%),97 (5.1%)
2,Royal Albert Edward Infirmary,A_7days,252,252,217,35,217 (86.1%),0 (0%)
2,Royal Albert Edward Infirmary,B_8_14days,370,370,313,57,313 (84.6%),0 (0%)
2,Royal Albert Edward Infirmary,C_15_21days,218,218,172,46,172 (78.9%),0 (0%)
2,Royal Albert Edward Infirmary,D_22_28days,334,334,286,48,286 (85.6%),0 (0%)
2,Royal Albert Edward Infirmary,E_28days,1353,1353,1019,334,1019 (75.3%),0 (0%)
2,Royal Albert Edward Infirmary,TOTAL,2527,2527,2007,520,2007 (79.4%),0 (0%)
2,Royal Lancaster Infirmary,A_7days,142,136,91,45,91 (66.9%),6 (4.2%)
2,Royal Lancaster Infirmary,B_8_14days,210,200,99,101,99 (49.5%),10 (4.8%)
2,Royal Lancaster Infirmary,C_15_21days,352,337,155,182,155 (46%),15 (4.3%)
2,Royal Lancaster Infirmary,D_22_28days,418,398,130,268,130 (32.7%),20 (4.8%)
2,Royal Lancaster Infirmary,E_28days,878,834,365,469,365 (43.8%),44 (5%)
2,Royal Lancaster Infirmary,TOTAL,2000,1905,840,1065,840 (44.1%),95 (4.8%)
2,Stepping Hill Hospital,A_7days,260,251,167,84,167 (66.5%),9 (3.5%)
2,Stepping Hill Hospital,B_8_14days,576,570,401,169,401 (70.4%),6 (1%)
2,Stepping Hill Hospital,C_15_21days,380,364,233,131,233 (64%),16 (4.2%)
2,Stepping Hill Hospital,D_22_28days,209,200,113,87,113 (56.5%),9 (4.3%)
2,Stepping Hill Hospital,E_28days,1241,1180,708,472,708 (60%),61 (4.9%)
2,Stepping Hill Hospital,TOTAL,2666,2565,1622,943,1622 (63.2%),101 (3.8%)
2,Tameside General Hospital,A_7days,220,183,65,118,65 (35.5%),37 (16.8%)
2,Tameside General Hospital,B_8_14days,329,265,75,190,75 (28.3%),64 (19.5%)
2,Tameside General Hospital,C_15_21days,321,271,73,198,73 (26.9%),50 (15.6%)
2,Tameside General Hospital,D_22_28days,594,450,133,317,133 (29.6%),144 (24.2%)
2,Tameside General Hospital,E_28days,1195,937,225,712,225 (24%),258 (21.6%)
2,Tameside General Hospital,TOTAL,2659,2106,571,1535,571 (27.1%),553 (20.8%)
2,"Victoria Hospital, Blackpool",A_7days,323,286,134,152,134 (46.9%),37 (11.5%)
2,"Victoria Hospital, Blackpool",B_8_14days,661,577,186,391,186 (32.2%),84 (12.7%)
2,"Victoria Hospital, Blackpool",C_15_21days,381,344,95,249,95 (27.6%),37 (9.7%)
2,"Victoria Hospital, Blackpool",D_22_28days,338,308,74,234,74 (24%),30 (8.9%)
2,"Victoria Hospital, Blackpool",E_28days,1060,933,164,769,164 (17.6%),127 (12%)
2,"Victoria Hospital, Blackpool",TOTAL,2763,2448,653,1795,653 (26.7%),315 (11.4%)
2,Warrington Hospital,A_7days,199,177,121,56,121 (68.4%),22 (11.1%)
2,Warrington Hospital,B_8_14days,405,377,253,124,253 (67.1%),28 (6.9%)
2,Warrington Hospital,C_15_21days,602,501,347,154,347 (69.3%),101 (16.8%)
2,Warrington Hospital,D_22_28days,288,252,171,81,171 (67.9%),36 (12.5%)
2,Warrington Hospital,E_28days,1281,1126,661,465,661 (58.7%),155 (12.1%)
2,Warrington Hospital,TOTAL,2775,2433,1553,880,1553 (63.8%),342 (12.3%)
2,Whiston Hospital,A_7days,236,193,112,81,112 (58%),43 (18.2%)
2,Whiston Hospital,B_8_14days,294,254,139,115,139 (54.7%),40 (13.6%)
2,Whiston Hospital,C_15_21days,386,318,169,149,169 (53.1%),68 (17.6%)
2,Whiston Hospital,D_22_28days,545,446,258,188,258 (57.8%),99 (18.2%)
2,Whiston Hospital,E_28days,1311,1084,581,503,581 (53.6%),227 (17.3%)
2,Whiston Hospital,TOTAL,2772,2295,1259,1036,1259 (54.9%),477 (17.2%)
2,Wythenshawe Hospital,A_7days,292,292,154,138,154 (52.7%),0 (0%)
2,Wythenshawe Hospital,B_8_14days,378,378,141,237,141 (37.3%),0 (0%)
2,Wythenshawe Hospital,C_15_21days,747,747,266,481,266 (35.6%),0 (0%)
2,Wythenshawe Hospital,D_22_28days,579,579,147,432,147 (25.4%),0 (0%)
2,Wythenshawe Hospital,E_28days,2963,2963,816,2147,816 (27.5%),0 (0%)
2,Wythenshawe Hospital,TOTAL,4959,4959,1524,3435,1524 (30.7%),0 (0%)
2,"Ayrshire Maternity Unit, Crosshouse",A_7days,273,269,76,193,76 (28.3%),4 (1.5%)
2,"Ayrshire Maternity Unit, Crosshouse",B_8_14days,409,408,71,337,71 (17.4%),1 (.2%)
2,"Ayrshire Maternity Unit, Crosshouse",C_15_21days,461,461,75,386,75 (16.3%),0 (0%)
2,"Ayrshire Maternity Unit, Crosshouse",D_22_28days,439,437,52,385,52 (11.9%),2 (.5%)
2,"Ayrshire Maternity Unit, Crosshouse",E_28days,2166,2166,261,1905,261 (12%),0 (0%)
2,"Ayrshire Maternity Unit, Crosshouse",TOTAL,3748,3741,535,3206,535 (14.3%),7 (.2%)
2,Forth Valley Royal Hospital,A_7days,201,198,81,117,81 (40.9%),3 (1.5%)
2,Forth Valley Royal Hospital,B_8_14days,416,405,110,295,110 (27.2%),11 (2.6%)
2,Forth Valley Royal Hospital,C_15_21days,414,405,76,329,76 (18.8%),9 (2.2%)
2,Forth Valley Royal Hospital,D_22_28days,344,344,61,283,61 (17.7%),0 (0%)
2,Forth Valley Royal Hospital,E_28days,1257,1243,281,962,281 (22.6%),14 (1.1%)
2,Forth Valley Royal Hospital,TOTAL,2632,2595,609,1986,609 (23.5%),37 (1.4%)
2,"Raigmore Hospital, Inverness",A_7days,138,130,73,57,73 (56.2%),8 (5.8%)
2,"Raigmore Hospital, Inverness",B_8_14days,451,429,221,208,221 (51.5%),22 (4.9%)
2,"Raigmore Hospital, Inverness",C_15_21days,410,373,156,217,156 (41.8%),37 (9%)
2,"Raigmore Hospital, Inverness",D_22_28days,423,394,140,254,140 (35.5%),29 (6.9%)
2,"Raigmore Hospital, Inverness",E_28days,932,873,280,593,280 (32.1%),59 (6.3%)
2,"Raigmore Hospital, Inverness",TOTAL,2354,2199,870,1329,870 (39.6%),155 (6.6%)
2,"Royal Alexandra Hospital, Paisley",A_7days,307,297,145,152,145 (48.8%),10 (3.3%)
2,"Royal Alexandra Hospital, Paisley",B_8_14days,605,566,199,367,199 (35.2%),39 (6.4%)
2,"Royal Alexandra Hospital, Paisley",C_15_21days,462,419,146,273,146 (34.8%),43 (9.3%)
2,"Royal Alexandra Hospital, Paisley",D_22_28days,267,234,73,161,73 (31.2%),33 (12.4%)
2,"Royal Alexandra Hospital, Paisley",E_28days,1095,1017,251,766,251 (24.7%),78 (7.1%)
2,"Royal Alexandra Hospital, Paisley",TOTAL,2736,2533,814,1719,814 (32.1%),203 (7.4%)
2,Gloucestershire Royal Hospital,A_7days,412,399,268,131,268 (67.2%),13 (3.2%)
2,Gloucestershire Royal Hospital,B_8_14days,1000,990,542,448,542 (54.7%),10 (1%)
2,Gloucestershire Royal Hospital,C_15_21days,835,819,436,383,436 (53.2%),16 (1.9%)
2,Gloucestershire Royal Hospital,D_22_28days,649,637,349,288,349 (54.8%),12 (1.8%)
2,Gloucestershire Royal Hospital,E_28days,2387,2338,989,1349,989 (42.3%),49 (2.1%)
2,Gloucestershire Royal Hospital,TOTAL,5283,5183,2584,2599,2584 (49.9%),100 (1.9%)
2,Great Western Hospital,A_7days,149,110,62,48,62 (56.4%),39 (26.2%)
2,Great Western Hospital,B_8_14days,409,296,153,143,153 (51.7%),113 (27.6%)
2,Great Western Hospital,C_15_21days,686,565,243,322,243 (43%),121 (17.6%)
2,Great Western Hospital,D_22_28days,622,496,206,290,206 (41.5%),126 (20.3%)
2,Great Western Hospital,E_28days,2699,2050,1059,991,1059 (51.7%),649 (24%)
2,Great Western Hospital,TOTAL,4565,3517,1723,1794,1723 (49%),1048 (23%)
2,Musgrove Park Hospital,A_7days,210,200,139,61,139 (69.5%),10 (4.8%)
2,Musgrove Park Hospital,B_8_14days,527,503,351,152,351 (69.8%),24 (4.6%)
2,Musgrove Park Hospital,C_15_21days,421,405,319,86,319 (78.8%),16 (3.8%)
2,Musgrove Park Hospital,D_22_28days,523,503,367,136,367 (73%),20 (3.8%)
2,Musgrove Park Hospital,E_28days,1579,1497,867,630,867 (57.9%),82 (5.2%)
2,Musgrove Park Hospital,TOTAL,3260,3108,2043,1065,2043 (65.7%),152 (4.7%)
2,Royal Cornwall Hospital,A_7days,260,245,187,58,187 (76.3%),15 (5.8%)
2,Royal Cornwall Hospital,B_8_14days,450,432,302,130,302 (69.9%),18 (4%)
2,Royal Cornwall Hospital,C_15_21days,311,304,189,115,189 (62.2%),7 (2.3%)
2,Royal Cornwall Hospital,D_22_28days,280,273,164,109,164 (60.1%),7 (2.5%)
2,Royal Cornwall Hospital,E_28days,1881,1763,742,1021,742 (42.1%),118 (6.3%)
2,Royal Cornwall Hospital,TOTAL,3182,3017,1584,1433,1584 (52.5%),165 (5.2%)
2,Royal Devon & Exeter Hospital,A_7days,335,315,259,56,259 (82.2%),20 (6%)
2,Royal Devon & Exeter Hospital,B_8_14days,647,616,526,90,526 (85.4%),31 (4.8%)
2,Royal Devon & Exeter Hospital,C_15_21days,663,621,498,123,498 (80.2%),42 (6.3%)
2,Royal Devon & Exeter Hospital,D_22_28days,296,272,211,61,211 (77.6%),24 (8.1%)
2,Royal Devon & Exeter Hospital,E_28days,2814,2621,1751,870,1751 (66.8%),193 (6.9%)
2,Royal Devon & Exeter Hospital,TOTAL,4755,4445,3245,1200,3245 (73%),310 (6.5%)
2,Royal United Hospital,A_7days,246,227,188,39,188 (82.8%),19 (7.7%)
2,Royal United Hospital,B_8_14days,495,450,342,108,342 (76%),45 (9.1%)
2,Royal United Hospital,C_15_21days,673,602,414,188,414 (68.8%),71 (10.5%)
2,Royal United Hospital,D_22_28days,533,429,308,121,308 (71.8%),104 (19.5%)
2,Royal United Hospital,E_28days,2028,1712,1244,468,1244 (72.7%),316 (15.6%)
2,Royal United Hospital,TOTAL,3975,3420,2496,924,2496 (73%),555 (14%)
2,Basingstoke & North Hampshire Hospital,A_7days,120,115,100,15,100 (87%),5 (4.2%)
2,Basingstoke & North Hampshire Hospital,B_8_14days,219,199,172,27,172 (86.4%),20 (9.1%)
2,Basingstoke & North Hampshire Hospital,C_15_21days,166,154,120,34,120 (77.9%),12 (7.2%)
2,Basingstoke & North Hampshire Hospital,D_22_28days,312,296,250,46,250 (84.5%),16 (5.1%)
2,Basingstoke & North Hampshire Hospital,E_28days,1485,1309,1063,246,1063 (81.2%),176 (11.9%)
2,Basingstoke & North Hampshire Hospital,TOTAL,2302,2073,1705,368,1705 (82.2%),229 (9.9%)
2,Milton Keynes University Hospital,A_7days,314,262,160,102,160 (61.1%),52 (16.6%)
2,Milton Keynes University Hospital,B_8_14days,356,291,168,123,168 (57.7%),65 (18.3%)
2,Milton Keynes University Hospital,C_15_21days,482,412,212,200,212 (51.5%),70 (14.5%)
2,Milton Keynes University Hospital,D_22_28days,418,367,205,162,205 (55.9%),51 (12.2%)
2,Milton Keynes University Hospital,E_28days,2180,1894,831,1063,831 (43.9%),286 (13.1%)
2,Milton Keynes University Hospital,TOTAL,3750,3226,1576,1650,1576 (48.9%),524 (14%)
2,Poole General Hospital,A_7days,364,309,204,105,204 (66%),55 (15.1%)
2,Poole General Hospital,B_8_14days,386,332,189,143,189 (56.9%),54 (14%)
2,Poole General Hospital,C_15_21days,465,401,154,247,154 (38.4%),64 (13.8%)
2,Poole General Hospital,D_22_28days,449,417,159,258,159 (38.1%),32 (7.1%)
2,Poole General Hospital,E_28days,2636,2150,704,1446,704 (32.7%),486 (18.4%)
2,Poole General Hospital,TOTAL,4300,3609,1410,2199,1410 (39.1%),691 (16.1%)
2,Royal Berkshire Hospital,A_7days,236,220,156,64,156 (70.9%),16 (6.8%)
2,Royal Berkshire Hospital,B_8_14days,395,363,211,152,211 (58.1%),32 (8.1%)
2,Royal Berkshire Hospital,C_15_21days,418,379,214,165,214 (56.5%),39 (9.3%)
2,Royal Berkshire Hospital,D_22_28days,374,353,217,136,217 (61.5%),21 (5.6%)
2,Royal Berkshire Hospital,E_28days,2118,1949,1232,717,1232 (63.2%),169 (8%)
2,Royal Berkshire Hospital,TOTAL,3541,3264,2030,1234,2030 (62.2%),277 (7.8%)
2,Royal Hampshire County Hospital,A_7days,116,108,77,31,77 (71.3%),8 (6.9%)
2,Royal Hampshire County Hospital,B_8_14days,248,219,143,76,143 (65.3%),29 (11.7%)
2,Royal Hampshire County Hospital,C_15_21days,301,284,161,123,161 (56.7%),17 (5.6%)
2,Royal Hampshire County Hospital,D_22_28days,267,246,163,83,163 (66.3%),21 (7.9%)
2,Royal Hampshire County Hospital,E_28days,868,802,406,396,406 (50.6%),66 (7.6%)
2,Royal Hampshire County Hospital,TOTAL,1800,1659,950,709,950 (57.3%),141 (7.8%)
2,Salisbury District Hospital,A_7days,246,186,131,55,131 (70.4%),60 (24.4%)
2,Salisbury District Hospital,B_8_14days,450,336,264,72,264 (78.6%),114 (25.3%)
2,Salisbury District Hospital,C_15_21days,270,220,149,71,149 (67.7%),50 (18.5%)
2,Salisbury District Hospital,D_22_28days,314,244,159,85,159 (65.2%),70 (22.3%)
2,Salisbury District Hospital,E_28days,713,552,332,220,332 (60.1%),161 (22.6%)
2,Salisbury District Hospital,TOTAL,1993,1538,1035,503,1035 (67.3%),455 (22.8%)
2,St Richard's Hospital,A_7days,154,143,46,97,46 (32.2%),11 (7.1%)
2,St Richard's Hospital,B_8_14days,288,274,105,169,105 (38.3%),14 (4.9%)
2,St Richard's Hospital,C_15_21days,416,398,145,253,145 (36.4%),18 (4.3%)
2,St Richard's Hospital,D_22_28days,437,421,142,279,142 (33.7%),16 (3.7%)
2,St Richard's Hospital,E_28days,456,442,130,312,130 (29.4%),14 (3.1%)
2,St Richard's Hospital,TOTAL,1751,1678,568,1110,568 (33.8%),73 (4.2%)
2,Stoke Mandeville Hospital,A_7days,197,184,144,40,144 (78.3%),13 (6.6%)
2,Stoke Mandeville Hospital,B_8_14days,351,339,249,90,249 (73.5%),12 (3.4%)
2,Stoke Mandeville Hospital,C_15_21days,598,577,368,209,368 (63.8%),21 (3.5%)
2,Stoke Mandeville Hospital,D_22_28days,543,521,334,187,334 (64.1%),22 (4.1%)
2,Stoke Mandeville Hospital,E_28days,1862,1762,1181,581,1181 (67%),100 (5.4%)
2,Stoke Mandeville Hospital,TOTAL,3551,3383,2276,1107,2276 (67.3%),168 (4.7%)
2,Wexham Park Hospital,A_7days,194,190,135,55,135 (71.1%),4 (2.1%)
2,Wexham Park Hospital,B_8_14days,409,400,217,183,217 (54.3%),9 (2.2%)
2,Wexham Park Hospital,C_15_21days,522,518,303,215,303 (58.5%),4 (.8%)
2,Wexham Park Hospital,D_22_28days,327,322,208,114,208 (64.6%),5 (1.5%)
2,Wexham Park Hospital,E_28days,1884,1865,758,1107,758 (40.6%),19 (1%)
2,Wexham Park Hospital,TOTAL,3336,3295,1621,1674,1621 (49.2%),41 (1.2%)
2,Glan Clwyd Hospital,A_7days,188,180,121,59,121 (67.2%),8 (4.3%)
2,Glan Clwyd Hospital,B_8_14days,271,266,158,108,158 (59.4%),5 (1.8%)
2,Glan Clwyd Hospital,C_15_21days,289,284,142,142,142 (50%),5 (1.7%)
2,Glan Clwyd Hospital,D_22_28days,391,377,205,172,205 (54.4%),14 (3.6%)
2,Glan Clwyd Hospital,E_28days,2379,2287,1178,1109,1178 (51.5%),92 (3.9%)
2,Glan Clwyd Hospital,TOTAL,3518,3394,1804,1590,1804 (53.2%),124 (3.5%)
2,Prince Charles Hospital,A_7days,338,302,135,167,135 (44.7%),36 (10.7%)
2,Prince Charles Hospital,B_8_14days,542,493,227,266,227 (46%),49 (9%)
2,Prince Charles Hospital,C_15_21days,610,566,197,369,197 (34.8%),44 (7.2%)
2,Prince Charles Hospital,D_22_28days,263,242,68,174,68 (28.1%),21 (8%)
2,Prince Charles Hospital,E_28days,976,895,245,650,245 (27.4%),81 (8.3%)
2,Prince Charles Hospital,TOTAL,2729,2498,872,1626,872 (34.9%),231 (8.5%)
2,Birmingham City Hospital,A_7days,640,629,145,484,145 (23.1%),11 (1.7%)
2,Birmingham City Hospital,B_8_14days,918,912,162,750,162 (17.8%),6 (.7%)
2,Birmingham City Hospital,C_15_21days,770,743,142,601,142 (19.1%),27 (3.5%)
2,Birmingham City Hospital,D_22_28days,790,778,132,646,132 (17%),12 (1.5%)
2,Birmingham City Hospital,E_28days,3242,3211,462,2749,462 (14.4%),31 (1%)
2,Birmingham City Hospital,TOTAL,6360,6273,1043,5230,1043 (16.6%),87 (1.4%)
2,Manor Hospital,A_7days,373,338,211,127,211 (62.4%),35 (9.4%)
2,Manor Hospital,B_8_14days,548,501,290,211,290 (57.9%),47 (8.6%)
2,Manor Hospital,C_15_21days,529,493,264,229,264 (53.5%),36 (6.8%)
2,Manor Hospital,D_22_28days,294,270,124,146,124 (45.9%),24 (8.2%)
2,Manor Hospital,E_28days,1780,1656,846,810,846 (51.1%),124 (7%)
2,Manor Hospital,TOTAL,3524,3258,1735,1523,1735 (53.3%),266 (7.5%)
2,"Princess Royal Hospital, Telford",A_7days,340,328,187,141,187 (57%),12 (3.5%)
2,"Princess Royal Hospital, Telford",B_8_14days,492,453,241,212,241 (53.2%),39 (7.9%)
2,"Princess Royal Hospital, Telford",C_15_21days,405,356,190,166,190 (53.4%),49 (12.1%)
2,"Princess Royal Hospital, Telford",D_22_28days,621,580,273,307,273 (47.1%),41 (6.6%)
2,"Princess Royal Hospital, Telford",E_28days,2358,2090,1039,1051,1039 (49.7%),268 (11.4%)
2,"Princess Royal Hospital, Telford",TOTAL,4216,3807,1930,1877,1930 (50.7%),409 (9.7%)
2,Russell's Hall Hospital,A_7days,298,256,164,92,164 (64.1%),42 (14.1%)
2,Russell's Hall Hospital,B_8_14days,428,388,216,172,216 (55.7%),40 (9.3%)
2,Russell's Hall Hospital,C_15_21days,469,431,188,243,188 (43.6%),38 (8.1%)
2,Russell's Hall Hospital,D_22_28days,579,529,268,261,268 (50.7%),50 (8.6%)
2,Russell's Hall Hospital,E_28days,3071,2807,1307,1500,1307 (46.6%),264 (8.6%)
2,Russell's Hall Hospital,TOTAL,4845,4411,2143,2268,2143 (48.6%),434 (9%)
2,Worcestershire Royal Hospital,A_7days,229,193,96,97,96 (49.7%),36 (15.7%)
2,Worcestershire Royal Hospital,B_8_14days,427,374,151,223,151 (40.4%),53 (12.4%)
2,Worcestershire Royal Hospital,C_15_21days,304,266,111,155,111 (41.7%),38 (12.5%)
2,Worcestershire Royal Hospital,D_22_28days,421,347,99,248,99 (28.5%),74 (17.6%)
2,Worcestershire Royal Hospital,E_28days,2241,1826,462,1364,462 (25.3%),415 (18.5%)
2,Worcestershire Royal Hospital,TOTAL,3622,3006,919,2087,919 (30.6%),616 (17%)
2,Barnsley District General Hospital,A_7days,158,157,78,79,78 (49.7%),1 (.6%)
2,Barnsley District General Hospital,B_8_14days,287,286,156,130,156 (54.5%),1 (.3%)
2,Barnsley District General Hospital,C_15_21days,299,297,126,171,126 (42.4%),2 (.7%)
2,Barnsley District General Hospital,D_22_28days,556,554,233,321,233 (42.1%),2 (.4%)
2,Barnsley District General Hospital,E_28days,1724,1717,594,1123,594 (34.6%),7 (.4%)
2,Barnsley District General Hospital,TOTAL,3024,3011,1187,1824,1187 (39.4%),13 (.4%)
2,Calderdale Royal Hospital,A_7days,272,272,86,186,86 (31.6%),0 (0%)
2,Calderdale Royal Hospital,B_8_14days,519,519,144,375,144 (27.7%),0 (0%)
2,Calderdale Royal Hospital,C_15_21days,899,899,172,727,172 (19.1%),0 (0%)
2,Calderdale Royal Hospital,D_22_28days,510,510,78,432,78 (15.3%),0 (0%)
2,Calderdale Royal Hospital,E_28days,2271,2270,294,1976,294 (13%),1 (0%)
2,Calderdale Royal Hospital,TOTAL,4471,4470,774,3696,774 (17.3%),1 (0%)
2,Chesterfield Royal Hospital,A_7days,176,173,84,89,84 (48.6%),3 (1.7%)
2,Chesterfield Royal Hospital,B_8_14days,472,461,210,251,210 (45.6%),11 (2.3%)
2,Chesterfield Royal Hospital,C_15_21days,504,496,156,340,156 (31.5%),8 (1.6%)
2,Chesterfield Royal Hospital,D_22_28days,231,229,59,170,59 (25.8%),2 (.9%)
2,Chesterfield Royal Hospital,E_28days,1491,1454,440,1014,440 (30.3%),37 (2.5%)
2,Chesterfield Royal Hospital,TOTAL,2874,2813,949,1864,949 (33.7%),61 (2.1%)
2,Diana Princess of Wales Hospital,A_7days,173,156,90,66,90 (57.7%),17 (9.8%)
2,Diana Princess of Wales Hospital,B_8_14days,385,357,183,174,183 (51.3%),28 (7.3%)
2,Diana Princess of Wales Hospital,C_15_21days,377,361,154,207,154 (42.7%),16 (4.2%)
2,Diana Princess of Wales Hospital,D_22_28days,191,186,80,106,80 (43%),5 (2.6%)
2,Diana Princess of Wales Hospital,E_28days,1033,952,384,568,384 (40.3%),81 (7.8%)
2,Diana Princess of Wales Hospital,TOTAL,2159,2012,891,1121,891 (44.3%),147 (6.8%)
2,Doncaster Royal Infirmary,A_7days,151,151,25,126,25 (16.6%),0 (0%)
2,Doncaster Royal Infirmary,B_8_14days,545,545,128,417,128 (23.5%),0 (0%)
2,Doncaster Royal Infirmary,C_15_21days,504,504,92,412,92 (18.3%),0 (0%)
2,Doncaster Royal Infirmary,D_22_28days,478,478,100,378,100 (20.9%),0 (0%)
2,Doncaster Royal Infirmary,E_28days,2383,2383,414,1969,414 (17.4%),0 (0%)
2,Doncaster Royal Infirmary,TOTAL,4061,4061,759,3302,759 (18.7%),0 (0%)
2,Pinderfields General Infirmary (Pontefract),A_7days,305,210,80,130,80 (38.1%),95 (31.1%)
2,Pinderfields General Infirmary (Pontefract),B_8_14days,569,457,144,313,144 (31.5%),112 (19.7%)
2,Pinderfields General Infirmary (Pontefract),C_15_21days,548,451,152,299,152 (33.7%),97 (17.7%)
2,Pinderfields General Infirmary (Pontefract),D_22_28days,571,472,119,353,119 (25.2%),99 (17.3%)
2,Pinderfields General Infirmary (Pontefract),E_28days,2540,2084,508,1576,508 (24.4%),456 (18%)
2,Pinderfields General Infirmary (Pontefract),TOTAL,4533,3674,1003,2671,1003 (27.3%),859 (18.9%)
2,Rotherham District General Hospital,A_7days,161,138,56,82,56 (40.6%),23 (14.3%)
2,Rotherham District General Hospital,B_8_14days,415,321,106,215,106 (33%),94 (22.7%)
2,Rotherham District General Hospital,C_15_21days,453,368,129,239,129 (35.1%),85 (18.8%)
2,Rotherham District General Hospital,D_22_28days,567,437,161,276,161 (36.8%),130 (22.9%)
2,Rotherham District General Hospital,E_28days,1526,1103,316,787,316 (28.6%),423 (27.7%)
2,Rotherham District General Hospital,TOTAL,3122,2367,768,1599,768 (32.4%),755 (24.2%)
2,Scunthorpe General Hospital,A_7days,133,128,66,62,66 (51.6%),5 (3.8%)
2,Scunthorpe General Hospital,B_8_14days,322,311,166,145,166 (53.4%),11 (3.4%)
2,Scunthorpe General Hospital,C_15_21days,348,335,114,221,114 (34%),13 (3.7%)
2,Scunthorpe General Hospital,D_22_28days,354,346,137,209,137 (39.6%),8 (2.3%)
2,Scunthorpe General Hospital,E_28days,1308,1279,399,880,399 (31.2%),29 (2.2%)
2,Scunthorpe General Hospital,TOTAL,2465,2399,882,1517,882 (36.8%),66 (2.7%)
2,York District Hospital,A_7days,192,189,91,98,91 (48.1%),3 (1.6%)
2,York District Hospital,B_8_14days,319,297,135,162,135 (45.5%),22 (6.9%)
2,York District Hospital,C_15_21days,367,351,167,184,167 (47.6%),16 (4.4%)
2,York District Hospital,D_22_28days,333,322,123,199,123 (38.2%),11 (3.3%)
2,York District Hospital,E_28days,1477,1433,357,1076,357 (24.9%),44 (3%)
2,York District Hospital,TOTAL,2688,2592,873,1719,873 (33.7%),96 (3.6%)
3,Leicester Neonatal Service (Leicester Royal Infirmary and Leicester General Hospital),A_7days,802,688,288,400,288 (41.9%),114 (14.2%)
3,Leicester Neonatal Service (Leicester Royal Infirmary and Leicester General Hospital),B_8_14days,1803,1530,564,966,564 (36.9%),273 (15.1%)
3,Leicester Neonatal Service (Leicester Royal Infirmary and Leicester General Hospital),C_15_21days,1299,1118,428,690,428 (38.3%),181 (13.9%)
3,Leicester Neonatal Service (Leicester Royal Infirmary and Leicester General Hospital),D_22_28days,1102,985,283,702,283 (28.7%),117 (10.6%)
3,Leicester Neonatal Service (Leicester Royal Infirmary and Leicester General Hospital),E_28days,6767,5828,1731,4097,1731 (29.7%),939 (13.9%)
3,Leicester Neonatal Service (Leicester Royal Infirmary and Leicester General Hospital),TOTAL,11773,10149,3294,6855,3294 (32.5%),1624 (13.8%)
3,Nottingham City Hospital,A_7days,260,210,88,122,88 (41.9%),50 (19.2%)
3,Nottingham City Hospital,B_8_14days,460,361,135,226,135 (37.4%),99 (21.5%)
3,Nottingham City Hospital,C_15_21days,385,257,83,174,83 (32.3%),128 (33.2%)
3,Nottingham City Hospital,D_22_28days,509,408,130,278,130 (31.9%),101 (19.8%)
3,Nottingham City Hospital,E_28days,3839,2625,937,1688,937 (35.7%),1214 (31.6%)
3,Nottingham City Hospital,TOTAL,5453,3861,1373,2488,1373 (35.6%),1592 (29.2%)
3,Nottingham University Hospital (QMC),A_7days,332,271,135,136,135 (49.8%),61 (18.4%)
3,Nottingham University Hospital (QMC),B_8_14days,502,366,158,208,158 (43.2%),136 (27.1%)
3,Nottingham University Hospital (QMC),C_15_21days,437,349,167,182,167 (47.9%),88 (20.1%)
3,Nottingham University Hospital (QMC),D_22_28days,285,208,84,124,84 (40.4%),77 (27%)
3,Nottingham University Hospital (QMC),E_28days,3537,2542,1128,1414,1128 (44.4%),995 (28.1%)
3,Nottingham University Hospital (QMC),TOTAL,5093,3736,1672,2064,1672 (44.8%),1357 (26.6%)
3,Luton and Dunstable University Hospital,A_7days,516,458,251,207,251 (54.8%),58 (11.2%)
3,Luton and Dunstable University Hospital,B_8_14days,1291,1145,469,676,469 (41%),146 (11.3%)
3,Luton and Dunstable University Hospital,C_15_21days,814,724,302,422,302 (41.7%),90 (11.1%)
3,Luton and Dunstable University Hospital,D_22_28days,705,621,309,312,309 (49.8%),84 (11.9%)
3,Luton and Dunstable University Hospital,E_28days,5868,5246,2515,2731,2515 (47.9%),622 (10.6%)
3,Luton and Dunstable University Hospital,TOTAL,9194,8194,3846,4348,3846 (46.9%),1000 (10.9%)
3,Norfolk & Norwich University Hospital,A_7days,368,319,241,78,241 (75.5%),49 (13.3%)
3,Norfolk & Norwich University Hospital,B_8_14days,764,643,444,199,444 (69.1%),121 (15.8%)
3,Norfolk & Norwich University Hospital,C_15_21days,647,528,286,242,286 (54.2%),119 (18.4%)
3,Norfolk & Norwich University Hospital,D_22_28days,899,705,367,338,367 (52.1%),194 (21.6%)
3,Norfolk & Norwich University Hospital,E_28days,5032,3995,1956,2039,1956 (49%),1037 (20.6%)
3,Norfolk & Norwich University Hospital,TOTAL,7710,6190,3294,2896,3294 (53.2%),1520 (19.7%)
3,"Rosie Maternity Hospital, Addenbrookes",A_7days,735,700,273,427,273 (39%),35 (4.8%)
3,"Rosie Maternity Hospital, Addenbrookes",B_8_14days,1245,1148,405,743,405 (35.3%),97 (7.8%)
3,"Rosie Maternity Hospital, Addenbrookes",C_15_21days,1617,1487,505,982,505 (34%),130 (8%)
3,"Rosie Maternity Hospital, Addenbrookes",D_22_28days,868,796,233,563,233 (29.3%),72 (8.3%)
3,"Rosie Maternity Hospital, Addenbrookes",E_28days,6285,5583,1414,4169,1414 (25.3%),702 (11.2%)
3,"Rosie Maternity Hospital, Addenbrookes",TOTAL,10750,9714,2830,6884,2830 (29.1%),1036 (9.6%)
3,Medway Maritime Hospital,A_7days,561,556,224,332,224 (40.3%),5 (.9%)
3,Medway Maritime Hospital,B_8_14days,1026,1022,311,711,311 (30.4%),4 (.4%)
3,Medway Maritime Hospital,C_15_21days,626,626,131,495,131 (20.9%),0 (0%)
3,Medway Maritime Hospital,D_22_28days,577,576,149,427,149 (25.9%),1 (.2%)
3,Medway Maritime Hospital,E_28days,3415,3415,784,2631,784 (23%),0 (0%)
3,Medway Maritime Hospital,TOTAL,6205,6195,1599,4596,1599 (25.8%),10 (.2%)
3,Royal Sussex County Hospital,A_7days,374,230,55,175,55 (23.9%),144 (38.5%)
3,Royal Sussex County Hospital,B_8_14days,708,373,79,294,79 (21.2%),335 (47.3%)
3,Royal Sussex County Hospital,C_15_21days,847,507,91,416,91 (17.9%),340 (40.1%)
3,Royal Sussex County Hospital,D_22_28days,800,491,53,438,53 (10.8%),309 (38.6%)
3,Royal Sussex County Hospital,E_28days,3952,2116,294,1822,294 (13.9%),1836 (46.5%)
3,Royal Sussex County Hospital,TOTAL,6681,3717,572,3145,572 (15.4%),2964 (44.4%)
3,St Peter's Hospital,A_7days,359,346,127,219,127 (36.7%),13 (3.6%)
3,St Peter's Hospital,B_8_14days,598,589,175,414,175 (29.7%),9 (1.5%)
3,St Peter's Hospital,C_15_21days,471,469,176,293,176 (37.5%),2 (.4%)
3,St Peter's Hospital,D_22_28days,609,604,193,411,193 (32%),5 (.8%)
3,St Peter's Hospital,E_28days,2391,2378,680,1698,680 (28.6%),13 (.5%)
3,St Peter's Hospital,TOTAL,4428,4386,1351,3035,1351 (30.8%),42 (.9%)
3,William Harvey Hospital,A_7days,207,201,58,143,58 (28.9%),6 (2.9%)
3,William Harvey Hospital,B_8_14days,574,549,101,448,101 (18.4%),25 (4.4%)
3,William Harvey Hospital,C_15_21days,671,658,105,553,105 (16%),13 (1.9%)
3,William Harvey Hospital,D_22_28days,675,653,116,537,116 (17.8%),22 (3.3%)
3,William Harvey Hospital,E_28days,3234,3216,341,2875,341 (10.6%),18 (.6%)
3,William Harvey Hospital,TOTAL,5361,5277,721,4556,721 (13.7%),84 (1.6%)
3,Homerton University Hospital,A_7days,746,744,736,8,736 (98.9%),2 (.3%)
3,Homerton University Hospital,B_8_14days,1382,1382,1360,22,1360 (98.4%),0 (0%)
3,Homerton University Hospital,C_15_21days,849,848,842,6,842 (99.3%),1 (.1%)
3,Homerton University Hospital,D_22_28days,688,687,676,11,676 (98.4%),1 (.1%)
3,Homerton University Hospital,E_28days,7382,7366,7304,62,7304 (99.2%),16 (.2%)
3,Homerton University Hospital,TOTAL,11047,11027,10918,109,10918 (99%),20 (.2%)
3,The Royal London Hospital,A_7days,554,349,88,261,88 (25.2%),205 (37%)
3,The Royal London Hospital,B_8_14days,898,561,148,413,148 (26.4%),337 (37.5%)
3,The Royal London Hospital,C_15_21days,941,583,124,459,124 (21.3%),358 (38%)
3,The Royal London Hospital,D_22_28days,741,467,94,373,94 (20.1%),274 (37%)
3,The Royal London Hospital,E_28days,8844,4882,894,3988,894 (18.3%),3962 (44.8%)
3,The Royal London Hospital,TOTAL,11978,6842,1348,5494,1348 (19.7%),5136 (42.9%)
3,Chelsea & Westminster Hospital,A_7days,434,425,250,175,250 (58.8%),9 (2.1%)
3,Chelsea & Westminster Hospital,B_8_14days,653,636,326,310,326 (51.3%),17 (2.6%)
3,Chelsea & Westminster Hospital,C_15_21days,859,850,383,467,383 (45.1%),9 (1%)
3,Chelsea & Westminster Hospital,D_22_28days,1051,1030,451,579,451 (43.8%),21 (2%)
3,Chelsea & Westminster Hospital,E_28days,6767,6739,2759,3980,2759 (40.9%),28 (.4%)
3,Chelsea & Westminster Hospital,TOTAL,9764,9680,4169,5511,4169 (43.1%),84 (.9%)
3,Queen Charlotte and Chelsea Hospital,A_7days,386,383,83,300,83 (21.7%),3 (.8%)
3,Queen Charlotte and Chelsea Hospital,B_8_14days,581,581,99,482,99 (17%),0 (0%)
3,Queen Charlotte and Chelsea Hospital,C_15_21days,294,290,44,246,44 (15.2%),4 (1.4%)
3,Queen Charlotte and Chelsea Hospital,D_22_28days,451,451,67,384,67 (14.9%),0 (0%)
3,Queen Charlotte and Chelsea Hospital,E_28days,4493,4453,517,3936,517 (11.6%),40 (.9%)
3,Queen Charlotte and Chelsea Hospital,TOTAL,6205,6158,810,5348,810 (13.2%),47 (.8%)
3,Evelina London Children's Hospital,A_7days,617,553,159,394,159 (28.8%),64 (10.4%)
3,Evelina London Children's Hospital,B_8_14days,1110,995,255,740,255 (25.6%),115 (10.4%)
3,Evelina London Children's Hospital,C_15_21days,798,714,198,516,198 (27.7%),84 (10.5%)
3,Evelina London Children's Hospital,D_22_28days,770,718,146,572,146 (20.3%),52 (6.8%)
3,Evelina London Children's Hospital,E_28days,7772,7580,1450,6130,1450 (19.1%),192 (2.5%)
3,Evelina London Children's Hospital,TOTAL,11067,10560,2208,8352,2208 (20.9%),507 (4.6%)
3,King's College Hospital,A_7days,385,343,177,166,177 (51.6%),42 (10.9%)
3,King's College Hospital,B_8_14days,572,489,251,238,251 (51.3%),83 (14.5%)
3,King's College Hospital,C_15_21days,758,655,295,360,295 (45%),103 (13.6%)
3,King's College Hospital,D_22_28days,703,619,282,337,282 (45.6%),84 (11.9%)
3,King's College Hospital,E_28days,6950,6123,2133,3990,2133 (34.8%),827 (11.9%)
3,King's College Hospital,TOTAL,9368,8229,3138,5091,3138 (38.1%),1139 (12.2%)
3,St George's Hospital,A_7days,474,380,176,204,176 (46.3%),94 (19.8%)
3,St George's Hospital,B_8_14days,955,705,270,435,270 (38.3%),250 (26.2%)
3,St George's Hospital,C_15_21days,988,717,251,466,251 (35%),271 (27.4%)
3,St George's Hospital,D_22_28days,807,519,177,342,177 (34.1%),288 (35.7%)
3,St George's Hospital,E_28days,8058,4968,1734,3234,1734 (34.9%),3090 (38.3%)
3,St George's Hospital,TOTAL,11282,7289,2608,4681,2608 (35.8%),3993 (35.4%)
3,Alder Hey Children's Hospital,A_7days,220,203,103,100,103 (50.7%),17 (7.7%)
3,Alder Hey Children's Hospital,B_8_14days,371,343,200,143,200 (58.3%),28 (7.5%)
3,Alder Hey Children's Hospital,C_15_21days,345,327,132,195,132 (40.4%),18 (5.2%)
3,Alder Hey Children's Hospital,D_22_28days,245,233,72,161,72 (30.9%),12 (4.9%)
3,Alder Hey Children's Hospital,E_28days,1452,1440,508,932,508 (35.3%),12 (.8%)
3,Alder Hey Children's Hospital,TOTAL,2633,2546,1015,1531,1015 (39.9%),87 (3.3%)
3,Arrowe Park Hospital,A_7days,169,153,90,63,90 (58.8%),16 (9.5%)
3,Arrowe Park Hospital,B_8_14days,350,313,215,98,215 (68.7%),37 (10.6%)
3,Arrowe Park Hospital,C_15_21days,395,354,243,111,243 (68.6%),41 (10.4%)
3,Arrowe Park Hospital,D_22_28days,446,384,229,155,229 (59.6%),62 (13.9%)
3,Arrowe Park Hospital,E_28days,3012,2761,1962,799,1962 (71.1%),251 (8.3%)
3,Arrowe Park Hospital,TOTAL,4372,3965,2739,1226,2739 (69.1%),407 (9.3%)
3,"Lancashire Women and Newborn Centre, Burnley General Hospital",A_7days,743,713,188,525,188 (26.4%),30 (4%)
3,"Lancashire Women and Newborn Centre, Burnley General Hospital",B_8_14days,881,845,198,647,198 (23.4%),36 (4.1%)
3,"Lancashire Women and Newborn Centre, Burnley General Hospital",C_15_21days,910,871,123,748,123 (14.1%),39 (4.3%)
3,"Lancashire Women and Newborn Centre, Burnley General Hospital",D_22_28days,697,680,100,580,100 (14.7%),17 (2.4%)
3,"Lancashire Women and Newborn Centre, Burnley General Hospital",E_28days,4377,4295,899,3396,899 (20.9%),82 (1.9%)
3,"Lancashire Women and Newborn Centre, Burnley General Hospital",TOTAL,7608,7404,1508,5896,1508 (20.4%),204 (2.7%)
3,Liverpool Women's Hospital,A_7days,690,617,208,409,208 (33.7%),73 (10.6%)
3,Liverpool Women's Hospital,B_8_14days,1318,1207,345,862,345 (28.6%),111 (8.4%)
3,Liverpool Women's Hospital,C_15_21days,1272,1231,234,997,234 (19%),41 (3.2%)
3,Liverpool Women's Hospital,D_22_28days,1028,1011,195,816,195 (19.3%),17 (1.7%)
3,Liverpool Women's Hospital,E_28days,6612,6454,1514,4940,1514 (23.5%),158 (2.4%)
3,Liverpool Women's Hospital,TOTAL,10920,10520,2496,8024,2496 (23.7%),400 (3.7%)
3,Royal Bolton Hospital,A_7days,544,424,210,214,210 (49.5%),120 (22.1%)
3,Royal Bolton Hospital,B_8_14days,1203,865,385,480,385 (44.5%),338 (28.1%)
3,Royal Bolton Hospital,C_15_21days,906,663,214,449,214 (32.3%),243 (26.8%)
3,Royal Bolton Hospital,D_22_28days,761,545,240,305,240 (44%),216 (28.4%)
3,Royal Bolton Hospital,E_28days,5544,4230,1658,2572,1658 (39.2%),1314 (23.7%)
3,Royal Bolton Hospital,TOTAL,8958,6727,2707,4020,2707 (40.2%),2231 (24.9%)
3,Royal Oldham Hospital,A_7days,401,331,87,244,87 (26.3%),70 (17.5%)
3,Royal Oldham Hospital,B_8_14days,792,654,205,449,205 (31.3%),138 (17.4%)
3,Royal Oldham Hospital,C_15_21days,1056,840,228,612,228 (27.1%),216 (20.5%)
3,Royal Oldham Hospital,D_22_28days,804,611,139,472,139 (22.7%),193 (24%)
3,Royal Oldham Hospital,E_28days,5427,4012,905,3107,905 (22.6%),1415 (26.1%)
3,Royal Oldham Hospital,TOTAL,8480,6448,1564,4884,1564 (24.3%),2032 (24%)
3,Royal Preston Hospital,A_7days,318,274,183,91,183 (66.8%),44 (13.8%)
3,Royal Preston Hospital,B_8_14days,527,451,296,155,296 (65.6%),76 (14.4%)
3,Royal Preston Hospital,C_15_21days,438,368,229,139,229 (62.2%),70 (16%)
3,Royal Preston Hospital,D_22_28days,489,405,231,174,231 (57%),84 (17.2%)
3,Royal Preston Hospital,E_28days,3922,3344,1794,1550,1794 (53.6%),578 (14.7%)
3,Royal Preston Hospital,TOTAL,5694,4842,2733,2109,2733 (56.4%),852 (15%)
3,"St Mary's Hospital, Manchester",A_7days,1010,931,337,594,337 (36.2%),79 (7.8%)
3,"St Mary's Hospital, Manchester",B_8_14days,1893,1732,402,1330,402 (23.2%),161 (8.5%)
3,"St Mary's Hospital, Manchester",C_15_21days,1357,1235,277,958,277 (22.4%),122 (9%)
3,"St Mary's Hospital, Manchester",D_22_28days,980,888,195,693,195 (22%),92 (9.4%)
3,"St Mary's Hospital, Manchester",E_28days,12434,11241,2346,8895,2346 (20.9%),1193 (9.6%)
3,"St Mary's Hospital, Manchester",TOTAL,17674,16027,3557,12470,3557 (22.2%),1647 (9.3%)
3,Royal Victoria Infirmary,A_7days,847,805,499,306,499 (62%),42 (5%)
3,Royal Victoria Infirmary,B_8_14days,1107,1017,590,427,590 (58%),90 (8.1%)
3,Royal Victoria Infirmary,C_15_21days,977,894,476,418,476 (53.2%),83 (8.5%)
3,Royal Victoria Infirmary,D_22_28days,884,799,382,417,382 (47.8%),85 (9.6%)
3,Royal Victoria Infirmary,E_28days,4829,4307,2396,1911,2396 (55.6%),522 (10.8%)
3,Royal Victoria Infirmary,TOTAL,8644,7822,4343,3479,4343 (55.5%),822 (9.5%)
3,Sunderland Royal Hospital,A_7days,239,218,131,87,131 (60.1%),21 (8.8%)
3,Sunderland Royal Hospital,B_8_14days,378,350,203,147,203 (58%),28 (7.4%)
3,Sunderland Royal Hospital,C_15_21days,500,459,219,240,219 (47.7%),41 (8.2%)
3,Sunderland Royal Hospital,D_22_28days,385,350,183,167,183 (52.3%),35 (9.1%)
3,Sunderland Royal Hospital,E_28days,2827,2494,1283,1211,1283 (51.4%),333 (11.8%)
3,Sunderland Royal Hospital,TOTAL,4329,3871,2019,1852,2019 (52.2%),458 (10.6%)
3,The James Cook University Hospital,A_7days,326,315,132,183,132 (41.9%),11 (3.4%)
3,The James Cook University Hospital,B_8_14days,838,820,277,543,277 (33.8%),18 (2.1%)
3,The James Cook University Hospital,C_15_21days,687,670,252,418,252 (37.6%),17 (2.5%)
3,The James Cook University Hospital,D_22_28days,496,484,153,331,153 (31.6%),12 (2.4%)
3,The James Cook University Hospital,E_28days,5483,5303,1738,3565,1738 (32.8%),180 (3.3%)
3,The James Cook University Hospital,TOTAL,7830,7592,2552,5040,2552 (33.6%),238 (3%)
3,Aberdeen Maternity Hospital,A_7days,462,457,113,344,113 (24.7%),5 (1.1%)
3,Aberdeen Maternity Hospital,B_8_14days,742,735,159,576,159 (21.6%),7 (.9%)
3,Aberdeen Maternity Hospital,C_15_21days,1036,1011,186,825,186 (18.4%),25 (2.4%)
3,Aberdeen Maternity Hospital,D_22_28days,674,674,111,563,111 (16.5%),0 (0%)
3,Aberdeen Maternity Hospital,E_28days,3483,3483,501,2982,501 (14.4%),0 (0%)
3,Aberdeen Maternity Hospital,TOTAL,6397,6360,1070,5290,1070 (16.8%),37 (.6%)
3,"Ninewells Hospital, Dundee",A_7days,323,323,146,177,146 (45.2%),0 (0%)
3,"Ninewells Hospital, Dundee",B_8_14days,616,614,290,324,290 (47.2%),2 (.3%)
3,"Ninewells Hospital, Dundee",C_15_21days,458,458,166,292,166 (36.2%),0 (0%)
3,"Ninewells Hospital, Dundee",D_22_28days,598,597,231,366,231 (38.7%),1 (.2%)
3,"Ninewells Hospital, Dundee",E_28days,3104,3104,719,2385,719 (23.2%),0 (0%)
3,"Ninewells Hospital, Dundee",TOTAL,5099,5096,1552,3544,1552 (30.5%),3 (.1%)
3,"Princess Royal Maternity Hospital, Glasgow",A_7days,359,336,120,216,120 (35.7%),23 (6.4%)
3,"Princess Royal Maternity Hospital, Glasgow",B_8_14days,728,704,276,428,276 (39.2%),24 (3.3%)
3,"Princess Royal Maternity Hospital, Glasgow",C_15_21days,584,573,176,397,176 (30.7%),11 (1.9%)
3,"Princess Royal Maternity Hospital, Glasgow",D_22_28days,501,497,151,346,151 (30.4%),4 (.8%)
3,"Princess Royal Maternity Hospital, Glasgow",E_28days,3662,3565,769,2796,769 (21.6%),97 (2.6%)
3,"Princess Royal Maternity Hospital, Glasgow",TOTAL,5834,5675,1492,4183,1492 (26.3%),159 (2.7%)
3,"Royal Hospital for Children, Glasgow ",A_7days,677,640,314,326,314 (49.1%),37 (5.5%)
3,"Royal Hospital for Children, Glasgow ",B_8_14days,1407,1327,584,743,584 (44%),80 (5.7%)
3,"Royal Hospital for Children, Glasgow ",C_15_21days,1478,1396,590,806,590 (42.3%),82 (5.5%)
3,"Royal Hospital for Children, Glasgow ",D_22_28days,1309,1228,386,842,386 (31.4%),81 (6.2%)
3,"Royal Hospital for Children, Glasgow ",E_28days,7377,6850,2146,4704,2146 (31.3%),527 (7.1%)
3,"Royal Hospital for Children, Glasgow ",TOTAL,12248,11441,4020,7421,4020 (35.1%),807 (6.6%)
3,"Simpson Centre for Reproductive Health, Edinburgh",A_7days,584,568,135,433,135 (23.8%),16 (2.7%)
3,"Simpson Centre for Reproductive Health, Edinburgh",B_8_14days,905,862,166,696,166 (19.3%),43 (4.8%)
3,"Simpson Centre for Reproductive Health, Edinburgh",C_15_21days,1019,978,118,860,118 (12.1%),41 (4%)
3,"Simpson Centre for Reproductive Health, Edinburgh",D_22_28days,615,586,65,521,65 (11.1%),29 (4.7%)
3,"Simpson Centre for Reproductive Health, Edinburgh",E_28days,6013,5836,840,4996,840 (14.4%),177 (2.9%)
3,"Simpson Centre for Reproductive Health, Edinburgh",TOTAL,9136,8830,1324,7506,1324 (15%),306 (3.3%)
3,"Victoria Hospital, Kirkcaldy",A_7days,269,269,169,100,169 (62.8%),0 (0%)
3,"Victoria Hospital, Kirkcaldy",B_8_14days,355,335,201,134,201 (60%),20 (5.6%)
3,"Victoria Hospital, Kirkcaldy",C_15_21days,456,442,244,198,244 (55.2%),14 (3.1%)
3,"Victoria Hospital, Kirkcaldy",D_22_28days,369,339,147,192,147 (43.4%),30 (8.1%)
3,"Victoria Hospital, Kirkcaldy",E_28days,1431,1327,486,841,486 (36.6%),104 (7.3%)
3,"Victoria Hospital, Kirkcaldy",TOTAL,2880,2712,1247,1465,1247 (46%),168 (5.8%)
3,Wishaw General Hospital,A_7days,542,540,206,334,206 (38.1%),2 (.4%)
3,Wishaw General Hospital,B_8_14days,836,836,277,559,277 (33.1%),0 (0%)
3,Wishaw General Hospital,C_15_21days,832,832,235,597,235 (28.2%),0 (0%)
3,Wishaw General Hospital,D_22_28days,639,639,140,499,140 (21.9%),0 (0%)
3,Wishaw General Hospital,E_28days,2856,2856,586,2270,586 (20.5%),0 (0%)
3,Wishaw General Hospital,TOTAL,5705,5703,1444,4259,1444 (25.3%),2 (0%)
3,Derriford Hospital,A_7days,253,220,135,85,135 (61.4%),33 (13%)
3,Derriford Hospital,B_8_14days,453,377,248,129,248 (65.8%),76 (16.8%)
3,Derriford Hospital,C_15_21days,431,368,232,136,232 (63%),63 (14.6%)
3,Derriford Hospital,D_22_28days,271,201,96,105,96 (47.8%),70 (25.8%)
3,Derriford Hospital,E_28days,2464,1929,1124,805,1124 (58.3%),535 (21.7%)
3,Derriford Hospital,TOTAL,3872,3095,1835,1260,1835 (59.3%),777 (20.1%)
3,Southmead Hospital,A_7days,337,234,125,109,125 (53.4%),103 (30.6%)
3,Southmead Hospital,B_8_14days,776,493,264,229,264 (53.5%),283 (36.5%)
3,Southmead Hospital,C_15_21days,623,463,231,232,231 (49.9%),160 (25.7%)
3,Southmead Hospital,D_22_28days,889,630,274,356,274 (43.5%),259 (29.1%)
3,Southmead Hospital,E_28days,5704,3554,1827,1727,1827 (51.4%),2150 (37.7%)
3,Southmead Hospital,TOTAL,8329,5374,2721,2653,2721 (50.6%),2955 (35.5%)
3,St Michael's Hospital,A_7days,396,267,179,88,179 (67%),129 (32.6%)
3,St Michael's Hospital,B_8_14days,757,515,329,186,329 (63.9%),242 (32%)
3,St Michael's Hospital,C_15_21days,778,489,350,139,350 (71.6%),289 (37.1%)
3,St Michael's Hospital,D_22_28days,513,387,237,150,237 (61.2%),126 (24.6%)
3,St Michael's Hospital,E_28days,5919,3880,2532,1348,2532 (65.3%),2039 (34.4%)
3,St Michael's Hospital,TOTAL,8363,5538,3627,1911,3627 (65.5%),2825 (33.8%)
3,John Radcliffe Hospital,A_7days,610,599,309,290,309 (51.6%),11 (1.8%)
3,John Radcliffe Hospital,B_8_14days,1166,1156,438,718,438 (37.9%),10 (.9%)
3,John Radcliffe Hospital,C_15_21days,936,919,292,627,292 (31.8%),17 (1.8%)
3,John Radcliffe Hospital,D_22_28days,625,620,151,469,151 (24.4%),5 (.8%)
3,John Radcliffe Hospital,E_28days,8019,7916,3008,4908,3008 (38%),103 (1.3%)
3,John Radcliffe Hospital,TOTAL,11356,11210,4198,7012,4198 (37.4%),146 (1.3%)
3,Princess Anne Hospital,A_7days,594,545,220,325,220 (40.4%),49 (8.2%)
3,Princess Anne Hospital,B_8_14days,988,827,316,511,316 (38.2%),161 (16.3%)
3,Princess Anne Hospital,C_15_21days,1058,867,264,603,264 (30.4%),191 (18.1%)
3,Princess Anne Hospital,D_22_28days,857,721,190,531,190 (26.4%),136 (15.9%)
3,Princess Anne Hospital,E_28days,6253,4963,1321,3642,1321 (26.6%),1290 (20.6%)
3,Princess Anne Hospital,TOTAL,9750,7923,2311,5612,2311 (29.2%),1827 (18.7%)
3,Queen Alexandra Hospital,A_7days,357,296,191,105,191 (64.5%),61 (17.1%)
3,Queen Alexandra Hospital,B_8_14days,794,650,395,255,395 (60.8%),144 (18.1%)
3,Queen Alexandra Hospital,C_15_21days,990,805,412,393,412 (51.2%),185 (18.7%)
3,Queen Alexandra Hospital,D_22_28days,868,669,360,309,360 (53.8%),199 (22.9%)
3,Queen Alexandra Hospital,E_28days,4853,3701,2174,1527,2174 (58.7%),1152 (23.7%)
3,Queen Alexandra Hospital,TOTAL,7862,6121,3532,2589,3532 (57.7%),1741 (22.1%)
3,Singleton Hospital,A_7days,534,523,280,243,280 (53.5%),11 (2.1%)
3,Singleton Hospital,B_8_14days,551,532,287,245,287 (53.9%),19 (3.4%)
3,Singleton Hospital,C_15_21days,505,499,221,278,221 (44.3%),6 (1.2%)
3,Singleton Hospital,D_22_28days,496,482,220,262,220 (45.6%),14 (2.8%)
3,Singleton Hospital,E_28days,3249,3146,1302,1844,1302 (41.4%),103 (3.2%)
3,Singleton Hospital,TOTAL,5335,5182,2310,2872,2310 (44.6%),153 (2.9%)
3,The Grange University Hospital,A_7days,528,471,289,182,289 (61.4%),57 (10.8%)
3,The Grange University Hospital,B_8_14days,1090,950,518,432,518 (54.5%),140 (12.8%)
3,The Grange University Hospital,C_15_21days,690,580,278,302,278 (47.9%),110 (15.9%)
3,The Grange University Hospital,D_22_28days,853,731,415,316,415 (56.8%),122 (14.3%)
3,The Grange University Hospital,E_28days,4466,3609,1846,1763,1846 (51.1%),857 (19.2%)
3,The Grange University Hospital,TOTAL,7627,6341,3346,2995,3346 (52.8%),1286 (16.9%)
3,University Hospital of Wales,A_7days,349,289,159,130,159 (55%),60 (17.2%)
3,University Hospital of Wales,B_8_14days,438,353,153,200,153 (43.3%),85 (19.4%)
3,University Hospital of Wales,C_15_21days,456,389,183,206,183 (47%),67 (14.7%)
3,University Hospital of Wales,D_22_28days,612,519,263,256,263 (50.7%),93 (15.2%)
3,University Hospital of Wales,E_28days,6280,5359,2558,2801,2558 (47.7%),921 (14.7%)
3,University Hospital of Wales,TOTAL,8135,6909,3316,3593,3316 (48%),1226 (15.1%)
3,Birmingham Heartlands Hospital,A_7days,422,399,114,285,114 (28.6%),23 (5.5%)
3,Birmingham Heartlands Hospital,B_8_14days,655,613,142,471,142 (23.2%),42 (6.4%)
3,Birmingham Heartlands Hospital,C_15_21days,829,736,144,592,144 (19.6%),93 (11.2%)
3,Birmingham Heartlands Hospital,D_22_28days,617,549,42,507,42 (7.7%),68 (11%)
3,Birmingham Heartlands Hospital,E_28days,6188,5428,986,4442,986 (18.2%),760 (12.3%)
3,Birmingham Heartlands Hospital,TOTAL,8711,7725,1428,6297,1428 (18.5%),986 (11.3%)
3,Birmingham Women's Hospital,A_7days,678,525,218,307,218 (41.5%),153 (22.6%)
3,Birmingham Women's Hospital,B_8_14days,1109,731,210,521,210 (28.7%),378 (34.1%)
3,Birmingham Women's Hospital,C_15_21days,946,563,128,435,128 (22.7%),383 (40.5%)
3,Birmingham Women's Hospital,D_22_28days,1223,603,159,444,159 (26.4%),620 (50.7%)
3,Birmingham Women's Hospital,E_28days,8112,4040,794,3246,794 (19.7%),4072 (50.2%)
3,Birmingham Women's Hospital,TOTAL,12068,6462,1509,4953,1509 (23.4%),5606 (46.5%)
3,New Cross Hospital,A_7days,454,432,185,247,185 (42.8%),22 (4.8%)
3,New Cross Hospital,B_8_14days,958,925,321,604,321 (34.7%),33 (3.4%)
3,New Cross Hospital,C_15_21days,812,788,216,572,216 (27.4%),24 (3%)
3,New Cross Hospital,D_22_28days,616,593,121,472,121 (20.4%),23 (3.7%)
3,New Cross Hospital,E_28days,3845,3809,894,2915,894 (23.5%),36 (.9%)
3,New Cross Hospital,TOTAL,6685,6547,1737,4810,1737 (26.5%),138 (2.1%)
3,Royal Stoke University Hospital,A_7days,428,378,184,194,184 (48.7%),50 (11.7%)
3,Royal Stoke University Hospital,B_8_14days,938,802,412,390,412 (51.4%),136 (14.5%)
3,Royal Stoke University Hospital,C_15_21days,742,650,277,373,277 (42.6%),92 (12.4%)
3,Royal Stoke University Hospital,D_22_28days,725,627,261,366,261 (41.6%),98 (13.5%)
3,Royal Stoke University Hospital,E_28days,4416,3922,1801,2121,1801 (45.9%),494 (11.2%)
3,Royal Stoke University Hospital,TOTAL,7249,6379,2935,3444,2935 (46%),870 (12%)
3,University Hospital Coventry,A_7days,535,336,111,225,111 (33%),199 (37.2%)
3,University Hospital Coventry,B_8_14days,937,568,151,417,151 (26.6%),369 (39.4%)
3,University Hospital Coventry,C_15_21days,770,378,115,263,115 (30.4%),392 (50.9%)
3,University Hospital Coventry,D_22_28days,781,485,124,361,124 (25.6%),296 (37.9%)
3,University Hospital Coventry,E_28days,5562,3082,852,2230,852 (27.6%),2480 (44.6%)
3,University Hospital Coventry,TOTAL,8585,4849,1353,3496,1353 (27.9%),3736 (43.5%)
3,Bradford Royal Infirmary,A_7days,231,191,77,114,77 (40.3%),40 (17.3%)
3,Bradford Royal Infirmary,B_8_14days,560,490,190,300,190 (38.8%),70 (12.5%)
3,Bradford Royal Infirmary,C_15_21days,574,528,147,381,147 (27.8%),46 (8%)
3,Bradford Royal Infirmary,D_22_28days,438,370,108,262,108 (29.2%),68 (15.5%)
3,Bradford Royal Infirmary,E_28days,6643,5745,1354,4391,1354 (23.6%),898 (13.5%)
3,Bradford Royal Infirmary,TOTAL,8446,7324,1876,5448,1876 (25.6%),1122 (13.3%)
3,Hull Royal Infirmary,A_7days,312,230,121,109,121 (52.6%),82 (26.3%)
3,Hull Royal Infirmary,B_8_14days,606,401,220,181,220 (54.9%),205 (33.8%)
3,Hull Royal Infirmary,C_15_21days,661,402,188,214,188 (46.8%),259 (39.2%)
3,Hull Royal Infirmary,D_22_28days,527,313,135,178,135 (43.1%),214 (40.6%)
3,Hull Royal Infirmary,E_28days,4480,2546,1062,1484,1062 (41.7%),1934 (43.2%)
3,Hull Royal Infirmary,TOTAL,6586,3892,1726,2166,1726 (44.3%),2694 (40.9%)
3,"Jessop Wing, Sheffield",A_7days,418,413,139,274,139 (33.7%),5 (1.2%)
3,"Jessop Wing, Sheffield",B_8_14days,770,769,231,538,231 (30%),1 (.1%)
3,"Jessop Wing, Sheffield",C_15_21days,713,703,157,546,157 (22.3%),10 (1.4%)
3,"Jessop Wing, Sheffield",D_22_28days,816,809,205,604,205 (25.3%),7 (.9%)
3,"Jessop Wing, Sheffield",E_28days,7168,7166,1554,5612,1554 (21.7%),2 (0%)
3,"Jessop Wing, Sheffield",TOTAL,9885,9860,2286,7574,2286 (23.2%),25 (.3%)
3,Leeds Neonatal Service (Leeds General Infirmary and St James's Hospital),A_7days,635,502,186,316,186 (37.1%),133 (20.9%)
3,Leeds Neonatal Service (Leeds General Infirmary and St James's Hospital),B_8_14days,1341,1141,388,753,388 (34%),200 (14.9%)
3,Leeds Neonatal Service (Leeds General Infirmary and St James's Hospital),C_15_21days,1501,1232,392,840,392 (31.8%),269 (17.9%)
3,Leeds Neonatal Service (Leeds General Infirmary and St James's Hospital),D_22_28days,1279,1074,296,778,296 (27.6%),205 (16%)
3,Leeds Neonatal Service (Leeds General Infirmary and St James's Hospital),E_28days,6557,5163,1477,3686,1477 (28.6%),1394 (21.3%)
3,Leeds Neonatal Service (Leeds General Infirmary and St James's Hospital),TOTAL,11313,9112,2739,6373,2739 (30.1%),2201 (19.5%)
TOTAL,TOTAL,A_7days,53047,47993,24366,23627,24366 (50.8%),5054 (9.5%)
TOTAL,TOTAL,B_8_14days,95051,85060,38013,47047,38013 (44.7%),9991 (10.5%)
TOTAL,TOTAL,C_15_21days,94410,84638,33425,51213,33425 (39.5%),9772 (10.4%)
TOTAL,TOTAL,D_22_28days,84042,74919,28038,46881,28038 (37.4%),9123 (10.9%)
TOTAL,TOTAL,E_28days,449803,391226,141031,250195,141031 (36%),58577 (13%)
TOTAL,TOTAL,TOTAL,776353,683836,264873,418963,264873 (38.7%),92517 (11.9%)
